Dominio:  eletrobras.gov.br	Nome: CENTRAIS ELETRICAS BRASILEIRAS SA
Dominio:  premioconservacaoenergia.gov.br	Nome: CENTRAIS ELETRICAS BRASILEIRAS SA
Dominio:  procel.gov.br	Nome: CENTRAIS ELETRICAS BRASILEIRAS SA
Dominio:  proinfa.gov.br	Nome: CENTRAIS ELETRICAS BRASILEIRAS SA
Dominio:  reluz.gov.br	Nome: CENTRAIS ELETRICAS BRASILEIRAS SA
Dominio:  bacen.gov.br	Nome: Banco Central do Brasil
Dominio:  bancocentral.gov.br	Nome: Banco Central do Brasil
Dominio:  bc.gov.br	Nome: Banco Central do Brasil
Dominio:  bcb.gov.br	Nome: Banco Central do Brasil
Dominio:  cidadaniafinanceira.gov.br	Nome: Banco Central do Brasil
Dominio:  sisbacen.gov.br	Nome: Banco Central do Brasil
Dominio:  selic.gov.br	Nome: Banco Central do Brasil
Dominio:  dnocs.gov.br	Nome: DEPARTAMENTO NACIONAL DE OBRAS CONTRA AS SECAS
Dominio:  dnocspb.gov.br	Nome: Segundo Distrito de Engenharia Rural
Dominio:  fhdf.gov.br	Nome: Secretaria de Saúde do Distrito Federal
Dominio:  funai.gov.br	Nome: Fundação Nacional do Indio
Dominio:  museudoindio.gov.br	Nome: Museu do Índio - Fundação Nacional do Índio
Dominio:  eletrosul.gov.br	Nome: Eletrosul Centrais Elétricas S.A.
Dominio:  bcdam.gov.br	Nome: COMPANHIA DE PESQUISA DE RECURSOS MINERAIS
Dominio:  cprm.gov.br	Nome: COMPANHIA DE PESQUISA DE RECURSOS MINERAIS
Dominio:  redegeochronos.gov.br	Nome: COMPANHIA DE PESQUISA DE RECURSOS MINERAIS
Dominio:  cprm-ma.gov.br	Nome: Companhia de Pesquisa de Recursos Minerais CPRM
Dominio:  cprm-be.gov.br	Nome: COMPANHIA DE PESQUISA DE RECURSOS MINERAIS
Dominio:  cprmba.gov.br	Nome: Companhia de Pesquisa de Recursos Minerais
Dominio:  cprm-sp.gov.br	Nome: Companhia de Pesquisa de Recursos Minerais
Dominio:  cprmpa.gov.br	Nome: Companhia de Pesquisas de Recursos Minerais CPRM
Dominio:  cprmbh.gov.br	Nome: Companhia de Pesquisa de Recursos Minerais - CPRM
Dominio:  saofrancisco.gov.br	Nome: Companhia de Pesquisa de Recursos Minerais - CPRM
Dominio:  reste.gov.br	Nome: Companhia de Pesquisa de Recursos Minerais
Dominio:  crecidf.gov.br	Nome: CONSELHO REGIONAL DE CORRETORES DE IMOVEIS CRECI
Dominio:  cfmv.gov.br	Nome: CONSELHO FEDERAL DE MEDICINA VETERINARIA
Dominio:  eafrs.gov.br	Nome: Escola Agrotécnica Federal de Rio do Sul
Dominio:  inb.gov.br	Nome: Industrias Nucleares do Brasil S/A
Dominio:  agritempo.gov.br	Nome: EMPRESA BRASILEIRA DE PESQUISA AGROPECUARIA
Dominio:  agrolivre.gov.br	Nome: EMPRESA BRASILEIRA DE PESQUISA AGROPECUARIA
Dominio:  pimentalonga.gov.br	Nome: Embrapa - Acre
Dominio:  embrapa.gov.br	Nome: Empresa Brasileira de Pesquisa Agropecuaria
Dominio:  aeroportodebrasilia.gov.br	Nome: INFRAERO - EMPRESA BRASILEIRA DE INFRA-ESTRUTURA
Dominio:  aeroportodesalvador.gov.br	Nome: INFRAERO - EMPRESA BRASILEIRA DE INFRA-ESTRUTURA
Dominio:  aeroportoindustria.gov.br	Nome: INFRAERO - EMPRESA BRASILEIRA DE INFRA-ESTRUTURA
Dominio:  aeroportoindustrial.gov.br	Nome: INFRAERO - EMPRESA BRASILEIRA DE INFRA-ESTRUTURA
Dominio:  aeroshopping.gov.br	Nome: INFRAERO - EMPRESA BRASILEIRA DE INFRA-ESTRUTURA
Dominio:  infraero.gov.br	Nome: INFRAERO - EMPRESA BRASILEIRA DE INFRA-ESTRUTURA
Dominio:  sivnet.gov.br	Nome: INFRAERO - EMPRESA BRASILEIRA DE INFRA-ESTRUTURA
Dominio:  tecanet.gov.br	Nome: INFRAERO - EMPRESA BRASILEIRA DE INFRA-ESTRUTURA
Dominio:  novoaeroportorecife.gov.br	Nome: INFRAERO - EMPRESA BRASILEIRA DE INFRA-ESTRUTURA
Dominio:  amazonasenergia.gov.br	Nome: Centrais Eletricas do Norte do Brasil
Dominio:  belomonte.gov.br	Nome: Centrais Eletricas do Norte do Brasil
Dominio:  boavistaenergia.gov.br	Nome: Centrais Eletricas do Norte do Brasil
Dominio:  bvenergia.gov.br	Nome: Centrais Eletricas do Norte do Brasil
Dominio:  cbee.gov.br	Nome: Centrais Eletricas do Norte do Brasil
Dominio:  coegv.gov.br	Nome: Centrais Eletricas do Norte do Brasil
Dominio:  eletronorte.gov.br	Nome: Centrais Eletricas do Norte do Brasil
Dominio:  eln.gov.br	Nome: Centrais Eletricas do Norte do Brasil
Dominio:  energiaboavista.gov.br	Nome: Centrais Eletricas do Norte do Brasil
Dominio:  energiabv.gov.br	Nome: Centrais Eletricas do Norte do Brasil
Dominio:  redefloresta.gov.br	Nome: Centrais Eletricas do Norte do Brasil
Dominio:  topawa-kaa.gov.br	Nome: Centrais Eletricas do Norte do Brasil
Dominio:  cadastrominhacasaminhavida.gov.br	Nome: CAIXA ECONOMICA FEDERAL
Dominio:  caixa.gov.br	Nome: CAIXA ECONOMICA FEDERAL
Dominio:  caixacultural.gov.br	Nome: CAIXA ECONOMICA FEDERAL
Dominio:  caixaeconomica.gov.br	Nome: CAIXA ECONOMICA FEDERAL
Dominio:  caixaeconomicafederal.gov.br	Nome: CAIXA ECONOMICA FEDERAL
Dominio:  caixamaisqueumbanco.gov.br	Nome: CAIXA ECONOMICA FEDERAL
Dominio:  caixamasterpass.gov.br	Nome: CAIXA ECONOMICA FEDERAL
Dominio:  caixaoperadoradeseguros.gov.br	Nome: CAIXA ECONOMICA FEDERAL
Dominio:  caixapostal.gov.br	Nome: CAIXA ECONOMICA FEDERAL
Dominio:  caixaseguridade.gov.br	Nome: CAIXA ECONOMICA FEDERAL
Dominio:  cef.gov.br	Nome: CAIXA ECONOMICA FEDERAL
Dominio:  creditoruralcaixa.gov.br	Nome: CAIXA ECONOMICA FEDERAL
Dominio:  fgts.gov.br	Nome: CAIXA ECONOMICA FEDERAL
Dominio:  postal.gov.br	Nome: CAIXA ECONOMICA FEDERAL
Dominio:  seliganacaixa.gov.br	Nome: CAIXA ECONOMICA FEDERAL
Dominio:  investidoresinstitucionais.gov.br	Nome: CAIXA ECONOMICA FEDERAL
Dominio:  caminhaodasorte.gov.br	Nome: CAIXA ECONOMICA FEDERAL
Dominio:  caminhaofederal.gov.br	Nome: CAIXA ECONOMICA FEDERAL
Dominio:  cartelafederal.gov.br	Nome: CAIXA ECONOMICA FEDERAL
Dominio:  loteriaesportiva.gov.br	Nome: CAIXA ECONOMICA FEDERAL
Dominio:  loteriafederal.gov.br	Nome: CAIXA ECONOMICA FEDERAL
Dominio:  quina.gov.br	Nome: CAIXA ECONOMICA FEDERAL
Dominio:  sena.gov.br	Nome: CAIXA ECONOMICA FEDERAL
Dominio:  supercaminhaodasorte.gov.br	Nome: CAIXA ECONOMICA FEDERAL
Dominio:  trevodaloteria.gov.br	Nome: CAIXA ECONOMICA FEDERAL
Dominio:  trincadasorte.gov.br	Nome: CAIXA ECONOMICA FEDERAL
Dominio:  bolsadacaixa.gov.br	Nome: CAIXA ECONOMICA FEDERAL
Dominio:  caixaqui.gov.br	Nome: CAIXA ECONOMICA FEDERAL
Dominio:  caixavirtual.gov.br	Nome: CAIXA ECONOMICA FEDERAL
Dominio:  esportiva.gov.br	Nome: CAIXA ECONOMICA FEDERAL
Dominio:  federal.gov.br	Nome: CAIXA ECONOMICA FEDERAL
Dominio:  govbankingcaixa.gov.br	Nome: CAIXA ECONOMICA FEDERAL
Dominio:  instantanea.gov.br	Nome: CAIXA ECONOMICA FEDERAL
Dominio:  mega-sena.gov.br	Nome: CAIXA ECONOMICA FEDERAL
Dominio:  megasena.gov.br	Nome: CAIXA ECONOMICA FEDERAL
Dominio:  rapidinha.gov.br	Nome: CAIXA ECONOMICA FEDERAL
Dominio:  supersenaduplachance.gov.br	Nome: CAIXA ECONOMICA FEDERAL
Dominio:  apostasurpresa.gov.br	Nome: CAIXA ECONOMICA FEDERAL
Dominio:  caixaresolve.gov.br	Nome: CAIXA ECONOMICA FEDERAL
Dominio:  chequeazul.gov.br	Nome: CAIXA ECONOMICA FEDERAL
Dominio:  construcard.gov.br	Nome: CAIXA ECONOMICA FEDERAL
Dominio:  federalcap.gov.br	Nome: CAIXA ECONOMICA FEDERAL
Dominio:  federalcard.gov.br	Nome: CAIXA ECONOMICA FEDERAL
Dominio:  guiafacilgps.gov.br	Nome: CAIXA ECONOMICA FEDERAL
Dominio:  loterias.gov.br	Nome: CAIXA ECONOMICA FEDERAL
Dominio:  officebankingsocial.gov.br	Nome: CAIXA ECONOMICA FEDERAL
Dominio:  teimozinha.gov.br	Nome: CAIXA ECONOMICA FEDERAL
Dominio:  bolaofederal.gov.br	Nome: CAIXA ECONOMICA FEDERAL
Dominio:  lojacaixa.gov.br	Nome: CAIXA ECONOMICA FEDERAL
Dominio:  loteca.gov.br	Nome: CAIXA ECONOMICA FEDERAL
Dominio:  loto-tauloteriadacopa.gov.br	Nome: CAIXA ECONOMICA FEDERAL
Dominio:  raspadinhadacaixa.gov.br	Nome: CAIXA ECONOMICA FEDERAL
Dominio:  raspadinhafederal.gov.br	Nome: CAIXA ECONOMICA FEDERAL
Dominio:  shoppingcaixa.gov.br	Nome: CAIXA ECONOMICA FEDERAL
Dominio:  supertrinca.gov.br	Nome: CAIXA ECONOMICA FEDERAL
Dominio:  trevodasorte.gov.br	Nome: CAIXA ECONOMICA FEDERAL
Dominio:  trevofederal.gov.br	Nome: CAIXA ECONOMICA FEDERAL
Dominio:  trinca.gov.br	Nome: CAIXA ECONOMICA FEDERAL
Dominio:  trinka.gov.br	Nome: CAIXA ECONOMICA FEDERAL
Dominio:  caixadasorte.gov.br	Nome: CAIXA ECONOMICA FEDERAL
Dominio:  caixadotesouro.gov.br	Nome: CAIXA ECONOMICA FEDERAL
Dominio:  caixaforte.gov.br	Nome: CAIXA ECONOMICA FEDERAL
Dominio:  carrocampeao.gov.br	Nome: CAIXA ECONOMICA FEDERAL
Dominio:  dinheiroaqui.gov.br	Nome: CAIXA ECONOMICA FEDERAL
Dominio:  dinheiroemcaixa.gov.br	Nome: CAIXA ECONOMICA FEDERAL
Dominio:  dinheiroinstantaneo.gov.br	Nome: CAIXA ECONOMICA FEDERAL
Dominio:  dinheirovivo.gov.br	Nome: CAIXA ECONOMICA FEDERAL
Dominio:  duplasena.gov.br	Nome: CAIXA ECONOMICA FEDERAL
Dominio:  loteriascaixa.gov.br	Nome: CAIXA ECONOMICA FEDERAL
Dominio:  lotofacil.gov.br	Nome: CAIXA ECONOMICA FEDERAL
Dominio:  lotomania.gov.br	Nome: CAIXA ECONOMICA FEDERAL
Dominio:  caixaaqui.gov.br	Nome: CAIXA ECONOMICA FEDERAL
Dominio:  caixainvest.gov.br	Nome: CAIXA ECONOMICA FEDERAL
Dominio:  caixainveste.gov.br	Nome: CAIXA ECONOMICA FEDERAL
Dominio:  e-conta.gov.br	Nome: CAIXA ECONOMICA FEDERAL
Dominio:  e-contacaixa.gov.br	Nome: CAIXA ECONOMICA FEDERAL
Dominio:  e-pagamentos.gov.br	Nome: CAIXA ECONOMICA FEDERAL
Dominio:  e-pagamentoscaixa.gov.br	Nome: CAIXA ECONOMICA FEDERAL
Dominio:  ecobrancacaixa.gov.br	Nome: CAIXA ECONOMICA FEDERAL
Dominio:  investcaixa.gov.br	Nome: CAIXA ECONOMICA FEDERAL
Dominio:  investecaixa.gov.br	Nome: CAIXA ECONOMICA FEDERAL
Dominio:  geipot.gov.br	Nome: EMPRESA BRASILEIRA DE PLANEJAMENTO DE
Dominio:  dpu.gov.br	Nome: Defensoria Pública-Geral da União
Dominio:  incra.gov.br	Nome: INCRA/INSTITUTO NACIONAL DE COLON E REF. AGRARIA
Dominio:  nead.gov.br	Nome: INCRA/INSTITUTO NACIONAL DE COLON E REF. AGRARIA
Dominio:  incra-pe.gov.br	Nome: Superint. Estadual de Pernambuco - Incra
Dominio:  incrarn.gov.br	Nome: Instituto Nacional de Colonizacao e Ref. Agraria
Dominio:  fnde.gov.br	Nome: FUNDO NACIONAL DE DESENVOLVIMENTO DA EDUCACAO
Dominio:  dnpm.gov.br	Nome: Departamento Nacional de Producao Mineral
Dominio:  pormin.gov.br	Nome: Departamento Nacional de Producao Mineral
Dominio:  dnpm-pe.gov.br	Nome: 4 Distrito DNPM - PE
Dominio:  dnpmsc.gov.br	Nome: DNPM - 11º Distrito
Dominio:  dnpmma.gov.br	Nome: DNPM - Depart. Nacional de Produção Mineral
Dominio:  bndespar.gov.br	Nome: BNDES Participações S/A
Dominio:  aerofacil.gov.br	Nome: PRESIDENCIA DA REPUBLICA
Dominio:  aplicativos.gov.br	Nome: PRESIDENCIA DA REPUBLICA
Dominio:  brasil.gov.br	Nome: PRESIDENCIA DA REPUBLICA
Dominio:  brazil.gov.br	Nome: PRESIDENCIA DA REPUBLICA
Dominio:  casacivil.gov.br	Nome: PRESIDENCIA DA REPUBLICA
Dominio:  cdes.gov.br	Nome: PRESIDENCIA DA REPUBLICA
Dominio:  cnv.gov.br	Nome: PRESIDENCIA DA REPUBLICA
Dominio:  confiancabrasil.gov.br	Nome: PRESIDENCIA DA REPUBLICA
Dominio:  confiancanobrasil.gov.br	Nome: PRESIDENCIA DA REPUBLICA
Dominio:  ctir.gov.br	Nome: PRESIDENCIA DA REPUBLICA
Dominio:  dialoga.gov.br	Nome: PRESIDENCIA DA REPUBLICA
Dominio:  emdefesadademocracia.gov.br	Nome: PRESIDENCIA DA REPUBLICA
Dominio:  fomezero.gov.br	Nome: PRESIDENCIA DA REPUBLICA
Dominio:  govbrasil.gov.br	Nome: PRESIDENCIA DA REPUBLICA
Dominio:  juventude.gov.br	Nome: PRESIDENCIA DA REPUBLICA
Dominio:  maisbrasil.gov.br	Nome: PRESIDENCIA DA REPUBLICA
Dominio:  minhacasaminhavida.gov.br	Nome: PRESIDENCIA DA REPUBLICA
Dominio:  nae.gov.br	Nome: PRESIDENCIA DA REPUBLICA
Dominio:  observatoriodegenero.gov.br	Nome: PRESIDENCIA DA REPUBLICA
Dominio:  odmbrasil.gov.br	Nome: PRESIDENCIA DA REPUBLICA
Dominio:  planalto.gov.br	Nome: PRESIDENCIA DA REPUBLICA
Dominio:  portosdobrasil.gov.br	Nome: PRESIDENCIA DA REPUBLICA
Dominio:  presidencia.gov.br	Nome: PRESIDENCIA DA REPUBLICA
Dominio:  presidenciadarepublica.gov.br	Nome: PRESIDENCIA DA REPUBLICA
Dominio:  prplanalto.gov.br	Nome: PRESIDENCIA DA REPUBLICA
Dominio:  regulacao.gov.br	Nome: PRESIDENCIA DA REPUBLICA
Dominio:  sae.gov.br	Nome: PRESIDENCIA DA REPUBLICA
Dominio:  senad.gov.br	Nome: PRESIDENCIA DA REPUBLICA
Dominio:  splp.gov.br	Nome: PRESIDENCIA DA REPUBLICA
Dominio:  cbnb.gov.br	Nome: TERCEIRO COMANDO AEREO REGIONAL
Dominio:  dac.gov.br	Nome: DEPARTAMENTO DE AVIACAO CIVIL - DAC
Dominio:  brmcc.gov.br	Nome: Departamento de Controle do Espaço Aéreo
Dominio:  cernai.gov.br	Nome: Departamento de Controle do Espaço Aéreo
Dominio:  cgna.gov.br	Nome: Departamento de Controle do Espaço Aéreo
Dominio:  dcea.gov.br	Nome: Departamento de Controle do Espaço Aéreo
Dominio:  decea.gov.br	Nome: Departamento de Controle do Espaço Aéreo
Dominio:  depv.gov.br	Nome: Departamento de Controle do Espaço Aéreo
Dominio:  icea.gov.br	Nome: Departamento de Controle do Espaço Aéreo
Dominio:  cindacta2.gov.br	Nome: Segundo Centro Integrado de Contr. Trafego Aéreo
Dominio:  pame.gov.br	Nome: Parque de Material de Eletrônica da Aeronáutica
Dominio:  serac4.gov.br	Nome: MAER QUARTO SERVIÇO REGIONAL DE AVIAÇÃO CIVIL
Dominio:  dtceaaf.gov.br	Nome: Comando da Aeronautica - SRPV-SP
Dominio:  dtceagl.gov.br	Nome: Comando da Aeronautica - SRPV-SP
Dominio:  dtceagw.gov.br	Nome: Comando da Aeronautica - SRPV-SP
Dominio:  dtceamt.gov.br	Nome: Comando da Aeronautica - SRPV-SP
Dominio:  dtceasc.gov.br	Nome: Comando da Aeronautica - SRPV-SP
Dominio:  dtceasj.gov.br	Nome: Comando da Aeronautica - SRPV-SP
Dominio:  dtceasp.gov.br	Nome: Comando da Aeronautica - SRPV-SP
Dominio:  dtceast.gov.br	Nome: Comando da Aeronautica - SRPV-SP
Dominio:  dtceatmrj.gov.br	Nome: Comando da Aeronautica - SRPV-SP
Dominio:  srpv-sp.gov.br	Nome: Comando da Aeronautica - SRPV-SP
Dominio:  srpvsp.gov.br	Nome: Comando da Aeronautica - SRPV-SP
Dominio:  hasp.gov.br	Nome: Hospital da Aeronautica de Sao Paulo
Dominio:  fab.gov.br	Nome: Centro de Computação da Aeronáutica de Brasília
Dominio:  maerj.gov.br	Nome: Departamento de Controle do Espaço Aéreo - SDTI
Dominio:  cenipa.gov.br	Nome: CENTRO DE INV E PREV DE ACIDENTES AERONÁUTICOS
Dominio:  ciscea.gov.br	Nome: COMISSAO DE IMPLANTACAO DO SISTEMA DE CONTROLE DO
Dominio:  sivam.gov.br	Nome: COMISSAO DE IMPLANTACAO DO SISTEMA DE CONTROLE DO
Dominio:  gesac.gov.br	Nome: Ministério das Comunicações
Dominio:  idbrasil.gov.br	Nome: Ministério das Comunicações
Dominio:  mc.gov.br	Nome: Ministério das Comunicações
Dominio:  comunicacoes.gov.br	Nome: Ministério das Comunicações
Dominio:  dominiopublico.gov.br	Nome: Ministério da Educação
Dominio:  educacao.gov.br	Nome: Ministério da Educação
Dominio:  educacion.gov.br	Nome: Ministério da Educação
Dominio:  education.gov.br	Nome: Ministério da Educação
Dominio:  abcnaidadecerta.gov.br	Nome: Ministério da Educação
Dominio:  mec.gov.br	Nome: Ministério da Educação
Dominio:  pracasdopac.gov.br	Nome: Ministério da Educação
Dominio:  simecpr.gov.br	Nome: Ministério da Educação
Dominio:  ibc.gov.br	Nome: Instituto Benjamin Constant
Dominio:  ines.gov.br	Nome: Instituto Nacional de Educacao de Surdos
Dominio:  proinfo.gov.br	Nome: Ministério da Educação
Dominio:  exercito.gov.br	Nome: MD/EB/Departamento de Ciência e Tecnologia
Dominio:  coletapilotocnae.gov.br	Nome: MINISTERIO DA FAZENDA
Dominio:  fazenda.gov.br	Nome: MINISTERIO DA FAZENDA
Dominio:  rfb.gov.br	Nome: MINISTERIO DA FAZENDA
Dominio:  casadoscontos.gov.br	Nome: Centro Regional de Treinamento ESAF
Dominio:  stn.gov.br	Nome: Secretaria do Tesouro Nacional
Dominio:  tesouro.gov.br	Nome: Secretaria do Tesouro Nacional
Dominio:  tesourotransparente.gov.br	Nome: Secretaria do Tesouro Nacional
Dominio:  aprendendoaexportar.gov.br	Nome: MINISTÉRIO DA INDUSTRIA, COMERCIO EXTERIOR E SERVI
Dominio:  brasilmaior.gov.br	Nome: MINISTÉRIO DA INDUSTRIA, COMERCIO EXTERIOR E SERVI
Dominio:  brasilmaisprodutivo.gov.br	Nome: MINISTÉRIO DA INDUSTRIA, COMERCIO EXTERIOR E SERVI
Dominio:  brazilianexporters.gov.br	Nome: MINISTÉRIO DA INDUSTRIA, COMERCIO EXTERIOR E SERVI
Dominio:  camex.gov.br	Nome: MINISTÉRIO DA INDUSTRIA, COMERCIO EXTERIOR E SERVI
Dominio:  comexbrasil.gov.br	Nome: MINISTÉRIO DA INDUSTRIA, COMERCIO EXTERIOR E SERVI
Dominio:  comexbrazil.gov.br	Nome: MINISTÉRIO DA INDUSTRIA, COMERCIO EXTERIOR E SERVI
Dominio:  comexresponde.gov.br	Nome: MINISTÉRIO DA INDUSTRIA, COMERCIO EXTERIOR E SERVI
Dominio:  desenvolvimento.gov.br	Nome: MINISTÉRIO DA INDUSTRIA, COMERCIO EXTERIOR E SERVI
Dominio:  encomex.gov.br	Nome: MINISTÉRIO DA INDUSTRIA, COMERCIO EXTERIOR E SERVI
Dominio:  expofeiras.gov.br	Nome: MINISTÉRIO DA INDUSTRIA, COMERCIO EXTERIOR E SERVI
Dominio:  exportabrasil.gov.br	Nome: MINISTÉRIO DA INDUSTRIA, COMERCIO EXTERIOR E SERVI
Dominio:  exportadoresbrasileiros.gov.br	Nome: MINISTÉRIO DA INDUSTRIA, COMERCIO EXTERIOR E SERVI
Dominio:  exportadoresbrasilenos.gov.br	Nome: MINISTÉRIO DA INDUSTRIA, COMERCIO EXTERIOR E SERVI
Dominio:  forumpermanente.gov.br	Nome: MINISTÉRIO DA INDUSTRIA, COMERCIO EXTERIOR E SERVI
Dominio:  jcdf.gov.br	Nome: MINISTÉRIO DA INDUSTRIA, COMERCIO EXTERIOR E SERVI
Dominio:  mdic.gov.br	Nome: MINISTÉRIO DA INDUSTRIA, COMERCIO EXTERIOR E SERVI
Dominio:  mict.gov.br	Nome: MINISTÉRIO DA INDUSTRIA, COMERCIO EXTERIOR E SERVI
Dominio:  observatoriodaindustria.gov.br	Nome: MINISTÉRIO DA INDUSTRIA, COMERCIO EXTERIOR E SERVI
Dominio:  pdp.gov.br	Nome: MINISTÉRIO DA INDUSTRIA, COMERCIO EXTERIOR E SERVI
Dominio:  portaldoempreendedor.gov.br	Nome: MINISTÉRIO DA INDUSTRIA, COMERCIO EXTERIOR E SERVI
Dominio:  portaldoexportador.gov.br	Nome: MINISTÉRIO DA INDUSTRIA, COMERCIO EXTERIOR E SERVI
Dominio:  portalexportacao.gov.br	Nome: MINISTÉRIO DA INDUSTRIA, COMERCIO EXTERIOR E SERVI
Dominio:  redeagentes.gov.br	Nome: MINISTÉRIO DA INDUSTRIA, COMERCIO EXTERIOR E SERVI
Dominio:  vitrinedoexportador.gov.br	Nome: MINISTÉRIO DA INDUSTRIA, COMERCIO EXTERIOR E SERVI
Dominio:  portaldaexportacao.gov.br	Nome: Ministério do Desenvolvimento
Dominio:  portalexporta.gov.br	Nome: Ministério do Desenvolvimento
Dominio:  consumidor.gov.br	Nome: MINISTERIO DA JUSTICA
Dominio:  conasp.gov.br	Nome: Secretaria Nacional de Segurança Pública
Dominio:  infoseg.gov.br	Nome: Secretaria Nacional de Segurança Pública
Dominio:  senasp.gov.br	Nome: Secretaria Nacional de Segurança Pública
Dominio:  acessoajustica.gov.br	Nome: MINISTERIO DA JUSTICA
Dominio:  atlasdeacessoajustica.gov.br	Nome: MINISTERIO DA JUSTICA
Dominio:  coracaoazul.gov.br	Nome: MINISTERIO DA JUSTICA
Dominio:  cquali.gov.br	Nome: MINISTERIO DA JUSTICA
Dominio:  crimecongress2010.gov.br	Nome: MINISTERIO DA JUSTICA
Dominio:  defensoriapublica.gov.br	Nome: MINISTERIO DA JUSTICA
Dominio:  defesadoconsumidor.gov.br	Nome: MINISTERIO DA JUSTICA
Dominio:  denatran.gov.br	Nome: MINISTERIO DA JUSTICA
Dominio:  enccla.gov.br	Nome: MINISTERIO DA JUSTICA
Dominio:  entreguesuaarma.gov.br	Nome: MINISTERIO DA JUSTICA
Dominio:  infopen.gov.br	Nome: MINISTERIO DA JUSTICA
Dominio:  justica.gov.br	Nome: MINISTERIO DA JUSTICA
Dominio:  migrantes.gov.br	Nome: MINISTERIO DA JUSTICA
Dominio:  mj.gov.br	Nome: MINISTERIO DA JUSTICA
Dominio:  pronasci.gov.br	Nome: MINISTERIO DA JUSTICA
Dominio:  qualidadedealimentos.gov.br	Nome: MINISTERIO DA JUSTICA
Dominio:  qualidadedoleite.gov.br	Nome: MINISTERIO DA JUSTICA
Dominio:  rndh.gov.br	Nome: MINISTERIO DA JUSTICA
Dominio:  sinesp.gov.br	Nome: MINISTERIO DA JUSTICA
Dominio:  traficodepessoas.gov.br	Nome: MINISTERIO DA JUSTICA
Dominio:  xn--justia-0ua.gov.br	Nome: MINISTERIO DA JUSTICA
Dominio:  dou.gov.br	Nome: Imprensa Nacional/Presidência da República
Dominio:  in.gov.br	Nome: Imprensa Nacional/Presidência da República
Dominio:  conseg.gov.br	Nome: Ministério da Justiça
Dominio:  dpf-ce.gov.br	Nome: SUPER. REGIONAL DA POLICIA FEDERAL NO CEARÁ
Dominio:  dpf.gov.br	Nome: DEPARTAMENTO DE POLICIA FEDERAL
Dominio:  pf.gov.br	Nome: DEPARTAMENTO DE POLICIA FEDERAL
Dominio:  policiafederal.gov.br	Nome: DEPARTAMENTO DE POLICIA FEDERAL
Dominio:  dnrc.gov.br	Nome: DEPARTAMENTO NACIONAL DE REGISTRO DO COMERCIO
Dominio:  dprf.gov.br	Nome: Departamento de Polícia Rodoviária Federal
Dominio:  prf.gov.br	Nome: Departamento de Polícia Rodoviária Federal
Dominio:  marinha.gov.br	Nome: DIR COMUNICACOES E TECNOLOGIA DA INFORMACAO DA MB
Dominio:  mb.gov.br	Nome: DIR COMUNICACOES E TECNOLOGIA DA INFORMACAO DA MB
Dominio:  mps.gov.br	Nome: Ministerio da Previdencia Social
Dominio:  mpas.gov.br	Nome: Ministerio da Previdencia e Assistencia Social
Dominio:  brasilcultura.gov.br	Nome: MINISTERIO DAS RELACOES EXTERIORES
Dominio:  portalconsular.gov.br	Nome: MINISTERIO DAS RELACOES EXTERIORES
Dominio:  rio20.gov.br	Nome: MINISTERIO DAS RELACOES EXTERIORES
Dominio:  antarcticabrazil.gov.br	Nome: MINISTERIO DAS RELACOES EXTERIORES
Dominio:  itamaraty.gov.br	Nome: MINISTERIO DAS RELACOES EXTERIORES
Dominio:  mercosul.gov.br	Nome: MINISTERIO DAS RELACOES EXTERIORES
Dominio:  mre.gov.br	Nome: MINISTERIO DAS RELACOES EXTERIORES
Dominio:  relacoesexteriores.gov.br	Nome: MINISTERIO DAS RELACOES EXTERIORES
Dominio:  brasilexport.gov.br	Nome: Min. Relações Exteriores Depto Promoção Comercial
Dominio:  brasilglobalnet.gov.br	Nome: Min. Relações Exteriores Depto Promoção Comercial
Dominio:  brasiltradenet.gov.br	Nome: Min. Relações Exteriores Depto Promoção Comercial
Dominio:  brazilexport.gov.br	Nome: Min. Relações Exteriores Depto Promoção Comercial
Dominio:  brazilglobalnet.gov.br	Nome: Min. Relações Exteriores Depto Promoção Comercial
Dominio:  braziltradenet.gov.br	Nome: Min. Relações Exteriores Depto Promoção Comercial
Dominio:  btig.gov.br	Nome: Min. Relações Exteriores Depto Promoção Comercial
Dominio:  btn.gov.br	Nome: Min. Relações Exteriores Depto Promoção Comercial
Dominio:  businessbrasil.gov.br	Nome: Min. Relações Exteriores Depto Promoção Comercial
Dominio:  businessbrazil.gov.br	Nome: Min. Relações Exteriores Depto Promoção Comercial
Dominio:  comercioeinvestimento.gov.br	Nome: Min. Relações Exteriores Depto Promoção Comercial
Dominio:  comex.gov.br	Nome: Min. Relações Exteriores Depto Promoção Comercial
Dominio:  dpr.gov.br	Nome: Min. Relações Exteriores Depto Promoção Comercial
Dominio:  investexportbrasil.gov.br	Nome: Min. Relações Exteriores Depto Promoção Comercial
Dominio:  investexportbrazil.gov.br	Nome: Min. Relações Exteriores Depto Promoção Comercial
Dominio:  invexbrasil.gov.br	Nome: Min. Relações Exteriores Depto Promoção Comercial
Dominio:  promocaocomercial.gov.br	Nome: Min. Relações Exteriores Depto Promoção Comercial
Dominio:  tradeandinvestment.gov.br	Nome: Min. Relações Exteriores Depto Promoção Comercial
Dominio:  tradepromotion.gov.br	Nome: Min. Relações Exteriores Depto Promoção Comercial
Dominio:  cdb.gov.br	Nome: Ministério das Relações Exteriores - DCD
Dominio:  jornadasdip.gov.br	Nome: Ministério das Relações Exteriores - DCD
Dominio:  pcdl.gov.br	Nome: Primeira Comissao Brasileira Demarcadora de Limite
Dominio:  scdl.gov.br	Nome: Seg. Com. Bras. Demarc. de Limites
Dominio:  abc.gov.br	Nome: Ministério das Relações Exteriores
Dominio:  nex.gov.br	Nome: Ministério das Relações Exteriores
Dominio:  gcth-sida.gov.br	Nome: Ministério da Saúde
Dominio:  conitec.gov.br	Nome: MINISTERIO DA SAUDE
Dominio:  ec.gov.br	Nome: MINISTERIO DA SAUDE
Dominio:  ensaiosclinicos.gov.br	Nome: MINISTERIO DA SAUDE
Dominio:  saude.gov.br	Nome: MINISTERIO DA SAUDE
Dominio:  cenp.gov.br	Nome: Centro Nacional de Primatas
Dominio:  iec.gov.br	Nome: FNS - Instituto Evandro Chagas
Dominio:  ipp.gov.br	Nome: Instituto Philippe Pinel
Dominio:  hrps.gov.br	Nome: Hospital Raphael de Paula Souza
Dominio:  cancer.gov.br	Nome: Instituto Nacional de Câncer
Dominio:  inca.gov.br	Nome: Instituto Nacional de Câncer
Dominio:  hgb.gov.br	Nome: Hospital Geral de Bonsucesso
Dominio:  hpiedade.gov.br	Nome: Hospital da Piedade
Dominio:  hcl.gov.br	Nome: Instituto Nacional de Cardiologia de Laranjeiras
Dominio:  datasus.gov.br	Nome: Ministério da Saúde
Dominio:  sus.gov.br	Nome: Ministério da Saúde
Dominio:  itaipu.gov.br	Nome: ITAIPU BINACIONAL
Dominio:  agricultura.gov.br	Nome: MINISTERIO DA AGRICULTURA E DO ABASTECIMENTO
Dominio:  inmet.gov.br	Nome: INSTITUTO NACIONAL DE METEOROLOGIA
Dominio:  matopiba.gov.br	Nome: Ministerio da Agricultura Pecuaria e Abastecimento
Dominio:  dfa-pe.gov.br	Nome: Ministério da Agricultura - DFA - Lapa - Recife
Dominio:  lapa-pe.gov.br	Nome: Ministério da Agricultura - DFA - Lapa - Recife
Dominio:  dfa-ba.gov.br	Nome: Ministério da Agricultura e do Abastecimento
Dominio:  dfasp.gov.br	Nome: Delegacia Federal de Agricultura em São Paulo
Dominio:  defesaagropecuaria.gov.br	Nome: Secretaria de Defesa Agropecuaria
Dominio:  laracps.gov.br	Nome: LABORATORIO REGIONAL DE APOIO ANIMAL
Dominio:  pronaf.gov.br	Nome: Ministerio do Desenvolvimento Agrario
Dominio:  codevasf.gov.br	Nome: COMPANHIA DE DESENVOLVIMENTO DO VALE DO SAO FRANCI
Dominio:  cnen.gov.br	Nome: Comissão Nacional de Energia Nuclear
Dominio:  ien.gov.br	Nome: Instituto de Engenharia Nuclear
Dominio:  ird.gov.br	Nome: INSTITUTO DE RADIOPROTECAO E DOSIMETRIA
Dominio:  cnenpc.gov.br	Nome: COMISSÃO NACIONAL DE ENERGIA NUCLEAR
Dominio:  crcn.gov.br	Nome: Centro Regional de Ciencias Nucleares
Dominio:  brasildigital.gov.br	Nome: Tribunal de Contas da União
Dominio:  contaspublicas.gov.br	Nome: Tribunal de Contas da União
Dominio:  eufiscalizo.gov.br	Nome: Tribunal de Contas da União
Dominio:  fiscalizacaorio2016.gov.br	Nome: Tribunal de Contas da União
Dominio:  fiscalizacopa2014.gov.br	Nome: Tribunal de Contas da União
Dominio:  fiscalizario2016.gov.br	Nome: Tribunal de Contas da União
Dominio:  fiscopa2014.gov.br	Nome: Tribunal de Contas da União
Dominio:  governancadosolo.gov.br	Nome: Tribunal de Contas da União
Dominio:  governancapublica.gov.br	Nome: Tribunal de Contas da União
Dominio:  olacefs.gov.br	Nome: Tribunal de Contas da União
Dominio:  publicgovernance.gov.br	Nome: Tribunal de Contas da União
Dominio:  redecontrole.gov.br	Nome: Tribunal de Contas da União
Dominio:  rededecontrole.gov.br	Nome: Tribunal de Contas da União
Dominio:  seminariobrasildigital.gov.br	Nome: Tribunal de Contas da União
Dominio:  tcu.gov.br	Nome: Tribunal de Contas da União
Dominio:  ticontrole.gov.br	Nome: Tribunal de Contas da União
Dominio:  tribunaiscplp.gov.br	Nome: Tribunal de Contas da União
Dominio:  cade.gov.br	Nome: Conselho Administrativo de Defesa Econômica
Dominio:  rpp.gov.br	Nome: Fundação de Amparo a Pesquisa do Estado do Piauí
Dominio:  imbel.gov.br	Nome: INDÚSTRIA DE MATERIAL BÉLICO DO BRASIL - IMBEL
Dominio:  bdjur.gov.br	Nome: SUPERIOR TRIBUNAL DE JUSTICA
Dominio:  consorciobdjur.gov.br	Nome: SUPERIOR TRIBUNAL DE JUSTICA
Dominio:  e-jud.gov.br	Nome: SUPERIOR TRIBUNAL DE JUSTICA
Dominio:  e-jus.gov.br	Nome: SUPERIOR TRIBUNAL DE JUSTICA
Dominio:  e-stj.gov.br	Nome: SUPERIOR TRIBUNAL DE JUSTICA
Dominio:  portaldajustica.gov.br	Nome: SUPERIOR TRIBUNAL DE JUSTICA
Dominio:  stj.gov.br	Nome: SUPERIOR TRIBUNAL DE JUSTICA
Dominio:  unijus.gov.br	Nome: SUPERIOR TRIBUNAL DE JUSTICA
Dominio:  varadafazenda.gov.br	Nome: SUPERIOR TRIBUNAL DE JUSTICA
Dominio:  abrasil.gov.br	Nome: Ministerio do Planejamento, Orcamento e Gestao
Dominio:  avancabrasil.gov.br	Nome: Ministerio do Planejamento, Orcamento e Gestao
Dominio:  bancodeoportunidades.gov.br	Nome: Ministerio do Planejamento, Orcamento e Gestao
Dominio:  colabora.gov.br	Nome: Ministerio do Planejamento, Orcamento e Gestao
Dominio:  consultaprotocolo.gov.br	Nome: Ministerio do Planejamento, Orcamento e Gestao
Dominio:  dados.gov.br	Nome: Ministerio do Planejamento, Orcamento e Gestao
Dominio:  dadosabertos.gov.br	Nome: Ministerio do Planejamento, Orcamento e Gestao
Dominio:  data.gov.br	Nome: Ministerio do Planejamento, Orcamento e Gestao
Dominio:  desafios.gov.br	Nome: Ministerio do Planejamento, Orcamento e Gestao
Dominio:  eixos.gov.br	Nome: Ministerio do Planejamento, Orcamento e Gestao
Dominio:  forumsipec.gov.br	Nome: Ministerio do Planejamento, Orcamento e Gestao
Dominio:  gestaoemdestaque.gov.br	Nome: Ministerio do Planejamento, Orcamento e Gestao
Dominio:  guiadeservicos.gov.br	Nome: Ministerio do Planejamento, Orcamento e Gestao
Dominio:  inclusaodigital.gov.br	Nome: Ministerio do Planejamento, Orcamento e Gestao
Dominio:  informacaoecidadania.gov.br	Nome: Ministerio do Planejamento, Orcamento e Gestao
Dominio:  inova.gov.br	Nome: Ministerio do Planejamento, Orcamento e Gestao
Dominio:  labcluster.gov.br	Nome: Ministerio do Planejamento, Orcamento e Gestao
Dominio:  mercadopublico.gov.br	Nome: Ministerio do Planejamento, Orcamento e Gestao
Dominio:  mp.gov.br	Nome: Ministerio do Planejamento, Orcamento e Gestao
Dominio:  mulhergoverno.gov.br	Nome: Ministerio do Planejamento, Orcamento e Gestao
Dominio:  noticias.gov.br	Nome: Ministerio do Planejamento, Orcamento e Gestao
Dominio:  pensesimples.gov.br	Nome: Ministerio do Planejamento, Orcamento e Gestao
Dominio:  pesquisa.gov.br	Nome: Ministerio do Planejamento, Orcamento e Gestao
Dominio:  pgi.gov.br	Nome: Ministerio do Planejamento, Orcamento e Gestao
Dominio:  planejamentoterritorial.gov.br	Nome: Ministerio do Planejamento, Orcamento e Gestao
Dominio:  protocolo.gov.br	Nome: Ministerio do Planejamento, Orcamento e Gestao
Dominio:  protocolointegrado.gov.br	Nome: Ministerio do Planejamento, Orcamento e Gestao
Dominio:  recadastramento.gov.br	Nome: Ministerio do Planejamento, Orcamento e Gestao
Dominio:  servicos.gov.br	Nome: Ministerio do Planejamento, Orcamento e Gestao
Dominio:  servir.gov.br	Nome: Ministerio do Planejamento, Orcamento e Gestao
Dominio:  sgi.gov.br	Nome: Ministerio do Planejamento, Orcamento e Gestao
Dominio:  sigepe.gov.br	Nome: Ministerio do Planejamento, Orcamento e Gestao
Dominio:  sispac.gov.br	Nome: Ministerio do Planejamento, Orcamento e Gestao
Dominio:  versionamento.gov.br	Nome: Ministerio do Planejamento, Orcamento e Gestao
Dominio:  vispublica.gov.br	Nome: Ministerio do Planejamento, Orcamento e Gestao
Dominio:  vlibras.gov.br	Nome: Ministerio do Planejamento, Orcamento e Gestao
Dominio:  xn--guiadeservios-sgb.gov.br	Nome: Ministerio do Planejamento, Orcamento e Gestao
Dominio:  xn--notcias-9ya.gov.br	Nome: Ministerio do Planejamento, Orcamento e Gestao
Dominio:  xn--servios-yxa.gov.br	Nome: Ministerio do Planejamento, Orcamento e Gestao
Dominio:  catir.gov.br	Nome: Ministerio do Planejamento Orçamento e Gestão
Dominio:  computadoresparainclusao.gov.br	Nome: Ministerio do Planejamento Orçamento e Gestão
Dominio:  convenios.gov.br	Nome: Ministerio do Planejamento Orçamento e Gestão
Dominio:  projetobrasilmunicipios.gov.br	Nome: Ministerio do Planejamento Orçamento e Gestão
Dominio:  siorg.gov.br	Nome: Ministerio do Planejamento Orçamento e Gestão
Dominio:  sisp.gov.br	Nome: Ministerio do Planejamento Orçamento e Gestão
Dominio:  brasilemcidades.gov.br	Nome: Ministério das Cidades
Dominio:  capacidades.gov.br	Nome: Ministério das Cidades
Dominio:  pbqp-h.gov.br	Nome: Ministério das Cidades
Dominio:  pncda.gov.br	Nome: Ministério das Cidades
Dominio:  rotasdascidades.gov.br	Nome: Ministério das Cidades
Dominio:  orcamento.gov.br	Nome: MINISTERIO DO PLANEJAMENTO, ORCAMENTO E GESTAO-MP
Dominio:  siop.gov.br	Nome: MINISTERIO DO PLANEJAMENTO, ORCAMENTO E GESTAO-MP
Dominio:  patrimoniodetodos.gov.br	Nome: Secretaria do Patromônio da União
Dominio:  stm.gov.br	Nome: SUPERIOR TRIBUNAL MILITAR
Dominio:  ac-jus.gov.br	Nome: CONSELHO DA JUSTICA FEDERAL
Dominio:  acjus.gov.br	Nome: CONSELHO DA JUSTICA FEDERAL
Dominio:  cjf.gov.br	Nome: CONSELHO DA JUSTICA FEDERAL
Dominio:  jf.gov.br	Nome: CONSELHO DA JUSTICA FEDERAL
Dominio:  justicafederal.gov.br	Nome: CONSELHO DA JUSTICA FEDERAL
Dominio:  jfsp.gov.br	Nome: Justiça Federal de São Paulo
Dominio:  jfpe.gov.br	Nome: Justica Federal de 1a Instancia
Dominio:  jfce.gov.br	Nome: Justiça Federal no Ceará
Dominio:  jfse.gov.br	Nome: Justica Federal - Secao Judiciaria do Estado de SE
Dominio:  jfal.gov.br	Nome: Justica Federal de Primeira Instância
Dominio:  jfrn.gov.br	Nome: Justiça Federal do Rio Grande do Norte
Dominio:  jfpb.gov.br	Nome: Justica Federal de Primeira Instancia
Dominio:  jfms.gov.br	Nome: Justiça Federal de 1ª Instância
Dominio:  eleicoes.gov.br	Nome: Tribunal Superior Eleitoral
Dominio:  justicaeleitoral.gov.br	Nome: Tribunal Superior Eleitoral
Dominio:  tse.gov.br	Nome: Tribunal Superior Eleitoral
Dominio:  tre-al.gov.br	Nome: Tribunal Regional Eleitoral de Alagoas
Dominio:  tre-am.gov.br	Nome: Tribunal Regional Eleitoral do Amazonas
Dominio:  tre-ba.gov.br	Nome: Tribunal Regional Eleitoral da Bahia
Dominio:  tre-ce.gov.br	Nome: Tribunal Regional Eleitoral do Ceará
Dominio:  tre-df.gov.br	Nome: Tribunal Regional Eleitoral do Distrito Federal
Dominio:  tre-es.gov.br	Nome: Tribunal Regional Eleitoral do Esprito do Santo
Dominio:  tre-go.gov.br	Nome: Tribunal Regional Eleitoral do Goias
Dominio:  tre-ma.gov.br	Nome: Tribunal Regional Eleitoral do Maranhão
Dominio:  tre-mg.gov.br	Nome: TRIBUNAL REGIONAL ELEITORAL DE MINAS GERAIS
Dominio:  tre-pa.gov.br	Nome: Tribunal Regional Eleitoral do Pará
Dominio:  tre-pb.gov.br	Nome: Tribunal Regional Eleitoral da Paraíba
Dominio:  tre-pe.gov.br	Nome: Tribunal Regional Eleitoral do Pernambuco
Dominio:  tre-pi.gov.br	Nome: Tribunal Regional Eleitoral do Piauí
Dominio:  tre-rj.gov.br	Nome: Tribunal Regional Eleitoral do Rio de Janeiro
Dominio:  tre-rn.gov.br	Nome: Tribunal Regional Eleitoral do Rio Grande do Norte
Dominio:  tre-rs.gov.br	Nome: TRIBUNAL REGIONAL ELEITORAL DO RIO GRANDE DO SUL
Dominio:  tre-sc.gov.br	Nome: Tribunal Regional Eleitoral de Santa Catarina
Dominio:  tre-sp.gov.br	Nome: Tribunal Regional Eleitoral de São Paulo
Dominio:  tre-se.gov.br	Nome: Tribunal Regional Eleitoral de Sergipe
Dominio:  tre-ac.gov.br	Nome: Tribunal Regional Eleitoral do Acre
Dominio:  tre-ms.gov.br	Nome: Tribunal Regional Eleitoral de MS
Dominio:  tre-to.gov.br	Nome: Tribunal Regional Eleitoral do Tocantins
Dominio:  tre-rr.gov.br	Nome: Tribunal Regional Eleitoral de Roraima
Dominio:  prove.gov.br	Nome: EMATER -DF
Dominio:  csjt.gov.br	Nome: TRIBUNAL SUPERIOR DO TRABALHO
Dominio:  enamat.gov.br	Nome: TRIBUNAL SUPERIOR DO TRABALHO
Dominio:  jt.gov.br	Nome: TRIBUNAL SUPERIOR DO TRABALHO
Dominio:  justicadotrabalho.gov.br	Nome: TRIBUNAL SUPERIOR DO TRABALHO
Dominio:  justra.gov.br	Nome: TRIBUNAL SUPERIOR DO TRABALHO
Dominio:  portaljt.gov.br	Nome: TRIBUNAL SUPERIOR DO TRABALHO
Dominio:  tribunaisdotrabalho.gov.br	Nome: TRIBUNAL SUPERIOR DO TRABALHO
Dominio:  tst.gov.br	Nome: TRIBUNAL SUPERIOR DO TRABALHO
Dominio:  trt05.gov.br	Nome: TRIBUNAL REGIONAL DO TRABALHO DA 5A. REGIAO
Dominio:  trt-pe.gov.br	Nome: TRIBUNAL REGIONAL DO TRABALHO DA 6A. REGIAO
Dominio:  trt6.gov.br	Nome: TRIBUNAL REGIONAL DO TRABALHO DA 6A. REGIAO
Dominio:  trt7.gov.br	Nome: Tribunal Regional do Trabalho da 7A. Regiao
Dominio:  trt9.gov.br	Nome: Tribunal Regional do Trabalho da 9ª Região
Dominio:  trt13.gov.br	Nome: Tribunal regional do Trabalho 13 Regiao
Dominio:  trt15.gov.br	Nome: Tribunal Regional do Trabalho da 15ª Região
Dominio:  trt17.gov.br	Nome: TRIBUNAL REGIONAL DO TRABALHO - 17A REGIAO
Dominio:  trt21.gov.br	Nome: Tribunal Regional do Trabalho da 21ª Região
Dominio:  trt22.gov.br	Nome: TRIBUNAL REGIONAL DO TRABALHO DA 22A. REGIAO
Dominio:  cidadania.gov.br	Nome: SENADO FEDERAL
Dominio:  congresso.gov.br	Nome: SENADO FEDERAL
Dominio:  copatransparente.gov.br	Nome: SENADO FEDERAL
Dominio:  interlegis.gov.br	Nome: SENADO FEDERAL
Dominio:  lexml.gov.br	Nome: SENADO FEDERAL
Dominio:  senado.gov.br	Nome: SENADO FEDERAL
Dominio:  senador.gov.br	Nome: SENADO FEDERAL
Dominio:  senadora.gov.br	Nome: SENADO FEDERAL
Dominio:  siga.gov.br	Nome: SENADO FEDERAL
Dominio:  sigabrasil.gov.br	Nome: SENADO FEDERAL
Dominio:  transparencianacopa.gov.br	Nome: SENADO FEDERAL
Dominio:  viibra.gov.br	Nome: SENADO FEDERAL
Dominio:  ilbsenado.gov.br	Nome: Secretaria Especial de Editoração e Publicações
Dominio:  agenciacamara.gov.br	Nome: Camara dos Deputados
Dominio:  camara.gov.br	Nome: Camara dos Deputados
Dominio:  camaradosdeputados.gov.br	Nome: Camara dos Deputados
Dominio:  cd.gov.br	Nome: Camara dos Deputados
Dominio:  deputado.gov.br	Nome: Camara dos Deputados
Dominio:  edemocracia.gov.br	Nome: Camara dos Deputados
Dominio:  opeixeeaartedepescar.gov.br	Nome: Camara dos Deputados
Dominio:  plenarinho.gov.br	Nome: Camara dos Deputados
Dominio:  radiocamara.gov.br	Nome: Camara dos Deputados
Dominio:  wikilegis.gov.br	Nome: Camara dos Deputados
Dominio:  aids.gov.br	Nome: Fundo Nacional de Saúde
Dominio:  saudenacopa.gov.br	Nome: Fundo Nacional de Saúde
Dominio:  cortesmercosul.gov.br	Nome: SUPREMO TRIBUNAL FEDERAL
Dominio:  cortesmercosur.gov.br	Nome: SUPREMO TRIBUNAL FEDERAL
Dominio:  diariodajustica.gov.br	Nome: SUPREMO TRIBUNAL FEDERAL
Dominio:  dj.gov.br	Nome: SUPREMO TRIBUNAL FEDERAL
Dominio:  infojus.gov.br	Nome: SUPREMO TRIBUNAL FEDERAL
Dominio:  radiojustica.gov.br	Nome: SUPREMO TRIBUNAL FEDERAL
Dominio:  rededojudiciario.gov.br	Nome: SUPREMO TRIBUNAL FEDERAL
Dominio:  rededopoderjudiciario.gov.br	Nome: SUPREMO TRIBUNAL FEDERAL
Dominio:  redejudiciario.gov.br	Nome: SUPREMO TRIBUNAL FEDERAL
Dominio:  stf.gov.br	Nome: SUPREMO TRIBUNAL FEDERAL
Dominio:  stfnet.gov.br	Nome: SUPREMO TRIBUNAL FEDERAL
Dominio:  tvjustica.gov.br	Nome: SUPREMO TRIBUNAL FEDERAL
Dominio:  tjdf.gov.br	Nome: TRIBUNAL DE JUSTICA DO DISTRITO FEDERAL
Dominio:  tjdft.gov.br	Nome: TRIBUNAL DE JUSTICA DO DISTRITO FEDERAL
Dominio:  coren-ap.gov.br	Nome: Conselho Regional de Enfermagem do Amapá - Coren
Dominio:  enap.gov.br	Nome: Escola Nacional de Administração Pública - ENAP
Dominio:  funag.gov.br	Nome: Fundação Alexandre de Gusmão
Dominio:  inmetrogo.gov.br	Nome: Superintendência Regional do Inmetro SUR-01/GO
Dominio:  infoconsumo.gov.br	Nome: INSTITUTO NACIONAL DE METROLOGIA, QUALIDADE E TECN
Dominio:  inmetro.gov.br	Nome: INSTITUTO NACIONAL DE METROLOGIA, QUALIDADE E TECN
Dominio:  oconsumidor.gov.br	Nome: INSTITUTO NACIONAL DE METROLOGIA, QUALIDADE E TECN
Dominio:  pbqp.gov.br	Nome: INSTITUTO NACIONAL DE METROLOGIA, QUALIDADE E TECN
Dominio:  portaldoconsumidor.gov.br	Nome: INSTITUTO NACIONAL DE METROLOGIA, QUALIDADE E TECN
Dominio:  sitedoconsumidor.gov.br	Nome: INSTITUTO NACIONAL DE METROLOGIA, QUALIDADE E TECN
Dominio:  inmetro-sc.gov.br	Nome: Inst Nac Metrologia e Norm Ind
Dominio:  rbmlq.gov.br	Nome: INMETRO INSTITUTO NAC DE METROL NORM E QUAL INDUST
Dominio:  inmetro-es.gov.br	Nome: Inst. Nac. Metrol., Normal. e Qual. Ind. Repr. ES
Dominio:  cfbio.gov.br	Nome: Conselho Federal de Biologia
Dominio:  eaf-sbf.gov.br	Nome: Escola Agrotecnica Federal de Senhor do Bonfim
Dominio:  eafsb.gov.br	Nome: Escola Agrotecnica Federal de Senhor do Bonfim
Dominio:  eafsrbonfim.gov.br	Nome: Escola Agrotecnica Federal de Senhor do Bonfim
Dominio:  eafsi.gov.br	Nome: Escola Agrotécnica Federal de Santa Inês - Bahia
Dominio:  capes.gov.br	Nome: FUNDACAO CAPES
Dominio:  cienciasemfronteiras.gov.br	Nome: FUNDACAO CAPES
Dominio:  vice-presidencia.gov.br	Nome: VICE PRESIDENCIA DA REPUBLICA
Dominio:  vicepresidenciadarepublica.gov.br	Nome: VICE PRESIDENCIA DA REPUBLICA
Dominio:  defesa.gov.br	Nome: Ministerio da Defesa
Dominio:  abin.gov.br	Nome: Agencia Brasileira de Inteligencia
Dominio:  ccom.gov.br	Nome: Agencia Brasileira de Inteligencia
Dominio:  cepesc.gov.br	Nome: Agencia Brasileira de Inteligencia
Dominio:  cin-sci.gov.br	Nome: Agencia Brasileira de Inteligencia
Dominio:  dinf.gov.br	Nome: Agencia Brasileira de Inteligencia
Dominio:  dte.gov.br	Nome: Agencia Brasileira de Inteligencia
Dominio:  linuxseguro.gov.br	Nome: Agencia Brasileira de Inteligencia
Dominio:  ls.gov.br	Nome: Agencia Brasileira de Inteligencia
Dominio:  orint.gov.br	Nome: Agencia Brasileira de Inteligencia
Dominio:  sisbin.gov.br	Nome: Agencia Brasileira de Inteligencia
Dominio:  geres.gov.br	Nome: Grupo Executivo P Recup Econ do Est Esp Santo
Dominio:  casabrasil.gov.br	Nome: Ministério da Ciência, Tecnologia e Inovação
Dominio:  ctnbio.gov.br	Nome: Ministério da Ciência, Tecnologia e Inovação
Dominio:  mct.gov.br	Nome: Ministério da Ciência, Tecnologia e Inovação
Dominio:  mcti.gov.br	Nome: Ministério da Ciência, Tecnologia e Inovação
Dominio:  redebrasil.gov.br	Nome: Ministério da Ciência, Tecnologia e Inovação
Dominio:  int.gov.br	Nome: Instituto Nacional de Tecnologia
Dominio:  cemaden.gov.br	Nome: INSTITUTO NACIONAL DE PESQUISAS ESPACIAIS
Dominio:  inpa.gov.br	Nome: INSTITUTO NACIONAL DE PESQUISAS DA AMAZONIA
Dominio:  inpe.gov.br	Nome: Instituto Nacional de Pesquisas Espaciais
Dominio:  insa.gov.br	Nome: Instituto Nacional do Semi-Árido-INSA
Dominio:  cetene.gov.br	Nome: Ministério da Ciência, Tecnologia e Inovação
Dominio:  rrc.gov.br	Nome: Ministério da Ciência, Tecnologia e Inovação
Dominio:  brasilia2010.gov.br	Nome: Ministério da Cultura
Dominio:  copadacultura.gov.br	Nome: Ministério da Cultura
Dominio:  cultura.gov.br	Nome: Ministério da Cultura
Dominio:  culturaviva.gov.br	Nome: Ministério da Cultura
Dominio:  minc.gov.br	Nome: Ministério da Cultura
Dominio:  mincrj.gov.br	Nome: Ministério da Cultura
Dominio:  mincsp.gov.br	Nome: Ministério da Cultura
Dominio:  monumenta.gov.br	Nome: Ministério da Cultura
Dominio:  pracas.gov.br	Nome: Ministério da Cultura
Dominio:  querovercultura.gov.br	Nome: Ministério da Cultura
Dominio:  vivaleitura.gov.br	Nome: Ministério da Cultura
Dominio:  pnll.gov.br	Nome: Ministério da Cultura
Dominio:  programadorabrasil.gov.br	Nome: MINISTÉRIO DA CULTURA / CINEMATECA BRASILEIRA
Dominio:  trt.gov.br	Nome: TRIBUNAL REGIONAL DO TRABALHO DA 3A REGIAO
Dominio:  trt3.gov.br	Nome: TRIBUNAL REGIONAL DO TRABALHO DA 3A REGIAO
Dominio:  trt20.gov.br	Nome: TRIBUNAL REGIONAL DO TRABALHO DA 20A. REGIAO
Dominio:  trt8.gov.br	Nome: TRIBUNAL REGIONAL DO TRABALHO - 8A REGIAO
Dominio:  amapa.gov.br	Nome: PRODAP - C. de Gestão da Tecnologia da Informação
Dominio:  ap.gov.br	Nome: PRODAP - C. de Gestão da Tecnologia da Informação
Dominio:  agriculturafamiliar.gov.br	Nome: Ministerio do Desenvolvimento Agrario
Dominio:  aiaf2014.gov.br	Nome: Ministerio do Desenvolvimento Agrario
Dominio:  bancodaterra.gov.br	Nome: Ministerio do Desenvolvimento Agrario
Dominio:  cnater.gov.br	Nome: Ministerio do Desenvolvimento Agrario
Dominio:  cndrs.gov.br	Nome: Ministerio do Desenvolvimento Agrario
Dominio:  cnir.gov.br	Nome: Ministerio do Desenvolvimento Agrario
Dominio:  condraf.gov.br	Nome: Ministerio do Desenvolvimento Agrario
Dominio:  convivio.gov.br	Nome: Ministerio do Desenvolvimento Agrario
Dominio:  ctis.gov.br	Nome: Ministerio do Desenvolvimento Agrario
Dominio:  desenvolvimentoagrario.gov.br	Nome: Ministerio do Desenvolvimento Agrario
Dominio:  desenvolvimentorural.gov.br	Nome: Ministerio do Desenvolvimento Agrario
Dominio:  emdiacomopronaf.gov.br	Nome: Ministerio do Desenvolvimento Agrario
Dominio:  mda.gov.br	Nome: Ministerio do Desenvolvimento Agrario
Dominio:  pndrss.gov.br	Nome: Ministerio do Desenvolvimento Agrario
Dominio:  pronera.gov.br	Nome: Ministerio do Desenvolvimento Agrario
Dominio:  reformaagraria.gov.br	Nome: Ministerio do Desenvolvimento Agrario
Dominio:  territoriosdacidadania.gov.br	Nome: Ministerio do Desenvolvimento Agrario
Dominio:  territoriosrurais.gov.br	Nome: Ministerio do Desenvolvimento Agrario
Dominio:  crecigo.gov.br	Nome: CONSELHO REG. DE CORRETORES DE IMOVEIS 5ªREGIAO/GO
Dominio:  trt11.gov.br	Nome: Tribunal Regional do Trabalho - 11ª Região
Dominio:  inep.gov.br	Nome: INSTITUTO NACIONAL DE ESTUDOS E PESQUISAS EDUCACIO
Dominio:  saemec.gov.br	Nome: INSTITUTO NACIONAL DE ESTUDOS E PESQUISAS EDUCACIO
Dominio:  crq12.gov.br	Nome: Conselho Regional de Química da 12a Região
Dominio:  to.gov.br	Nome: Governo do Estado do Tocantins
Dominio:  faesa-oscip.gov.br	Nome: FEDERAÇÃO DAS ASSOC. E ENTID. P/ DESENV. SEMIÁRIDO
Dominio:  trt10.gov.br	Nome: TRIBUNAL REGIONAL DO TRABALHO DA 10A. REGIAO
Dominio:  cgtee.gov.br	Nome: Companhia de Geração Termica de Energia Eletrica
Dominio:  anatel.gov.br	Nome: AGENCIA NACIONAL DE TELECOMUNICACOES - ANATEL
Dominio:  aneel.gov.br	Nome: ANEEL - Agência Nacional de Energia Elétrica
Dominio:  baciadoprata.gov.br	Nome: ANEEL - Agência Nacional de Energia Elétrica
Dominio:  citenel.gov.br	Nome: ANEEL - Agência Nacional de Energia Elétrica
Dominio:  mpes.gov.br	Nome: Ministério Público do Estado do Espírito Santo
Dominio:  anp.gov.br	Nome: Agência Nacional do Petróleo, Gás Natural e Bioco.
Dominio:  bdep.gov.br	Nome: Agência Nacional do Petróleo, Gás Natural e Bioco.
Dominio:  brasil-rounds.gov.br	Nome: Agência Nacional do Petróleo, Gás Natural e Bioco.
Dominio:  brazil-rounds.gov.br	Nome: Agência Nacional do Petróleo, Gás Natural e Bioco.
Dominio:  brazilrounds.gov.br	Nome: Agência Nacional do Petróleo, Gás Natural e Bioco.
Dominio:  educacaofiscal.gov.br	Nome: Escola de Administração Fazendária
Dominio:  egressos-esaf.gov.br	Nome: Escola de Administração Fazendária
Dominio:  gdfaz.gov.br	Nome: Escola de Administração Fazendária
Dominio:  manausenergia.gov.br	Nome: Manaus Energia S/A
Dominio:  crbio01.gov.br	Nome: Conselho Regional de Biologia
Dominio:  trt18.gov.br	Nome: Tribunal Regional do Trabalho da 18ª Região
Dominio:  crbio-02.gov.br	Nome: Conselho Regional Biologia 2ª Reg RJ/ES
Dominio:  crbio02.gov.br	Nome: Conselho Regional Biologia 2ª Reg RJ/ES
Dominio:  crbio2.gov.br	Nome: Conselho Regional Biologia 2ª Reg RJ/ES
Dominio:  tecnojusc.gov.br	Nome: TRIBUNAL REGIONAL DO TRABALHO 12 REGIAO
Dominio:  trt12.gov.br	Nome: TRIBUNAL REGIONAL DO TRABALHO 12 REGIAO
Dominio:  trtes.gov.br	Nome: Tribunal Regional do Trabalho 17ª Região
Dominio:  crbio-4.gov.br	Nome: Conselho Regional de Biologia - 4 região
Dominio:  crbio04.gov.br	Nome: Conselho Regional de Biologia - 4 região
Dominio:  trt4.gov.br	Nome: Tribunal Regional do Trabalho da 4 Regiao
Dominio:  teleceara.gov.br	Nome: Tele Norte Leste Participações S.A.
Dominio:  trt01.gov.br	Nome: Tribunal Regional do Trabalho da 1a Região
Dominio:  trtrio.gov.br	Nome: Tribunal Regional do Trabalho da 1a Região
Dominio:  crtr14.gov.br	Nome: CONSELHO REGIONAL DE TÉCNICO EM RADIOLOGIA 14ª REG
Dominio:  bid2002brasil.gov.br	Nome: Ministerio do Planejamento, Orcamento e Gestao
Dominio:  colab.gov.br	Nome: Ministerio do Planejamento, Orcamento e Gestao
Dominio:  d.gov.br	Nome: Ministerio do Planejamento, Orcamento e Gestao
Dominio:  gestaopublica.gov.br	Nome: Ministerio do Planejamento, Orcamento e Gestao
Dominio:  governoeletronico.gov.br	Nome: Ministerio do Planejamento, Orcamento e Gestao
Dominio:  infra-estruturabrasil.gov.br	Nome: Ministerio do Planejamento, Orcamento e Gestao
Dominio:  infraestruturabrasil.gov.br	Nome: Ministerio do Planejamento, Orcamento e Gestao
Dominio:  infrastructurebrazil.gov.br	Nome: Ministerio do Planejamento, Orcamento e Gestao
Dominio:  investinbrazil.gov.br	Nome: Ministerio do Planejamento, Orcamento e Gestao
Dominio:  pen.gov.br	Nome: Ministerio do Planejamento, Orcamento e Gestao
Dominio:  planejamento.gov.br	Nome: Ministerio do Planejamento, Orcamento e Gestao
Dominio:  planobrasil.gov.br	Nome: Ministerio do Planejamento, Orcamento e Gestao
Dominio:  premio-e.gov.br	Nome: Ministerio do Planejamento, Orcamento e Gestao
Dominio:  processoeletronico.gov.br	Nome: Ministerio do Planejamento, Orcamento e Gestao
Dominio:  processoeletroniconacional.gov.br	Nome: Ministerio do Planejamento, Orcamento e Gestao
Dominio:  redesocial.gov.br	Nome: Ministerio do Planejamento, Orcamento e Gestao
Dominio:  sei.gov.br	Nome: Ministerio do Planejamento, Orcamento e Gestao
Dominio:  servidor.gov.br	Nome: Ministerio do Planejamento, Orcamento e Gestao
Dominio:  sigplan.gov.br	Nome: Ministerio do Planejamento, Orcamento e Gestao
Dominio:  abcd.gov.br	Nome: ME - Ministerio do Esporte
Dominio:  brasil2016.gov.br	Nome: ME - Ministerio do Esporte
Dominio:  copa2014.gov.br	Nome: ME - Ministerio do Esporte
Dominio:  diesporte.gov.br	Nome: ME - Ministerio do Esporte
Dominio:  esporte.gov.br	Nome: ME - Ministerio do Esporte
Dominio:  jmpi2015.gov.br	Nome: ME - Ministerio do Esporte
Dominio:  portaldacopa.gov.br	Nome: ME - Ministerio do Esporte
Dominio:  torcidalegal.gov.br	Nome: ME - Ministerio do Esporte
Dominio:  voluntariado.gov.br	Nome: ME - Ministerio do Esporte
Dominio:  worldcup2014.gov.br	Nome: ME - Ministerio do Esporte
Dominio:  brasilvoluntario.gov.br	Nome: Ministério do Esporte
Dominio:  profae.gov.br	Nome: Secretaria de Gestão de Investimentos em Saúde
Dominio:  anvisa.gov.br	Nome: Agencia Nacional de Vigilancia Sanitaria
Dominio:  anvs.gov.br	Nome: Agencia Nacional de Vigilancia Sanitaria
Dominio:  clicksaudavel.gov.br	Nome: Agencia Nacional de Vigilancia Sanitaria
Dominio:  vigilanciasanitaria.gov.br	Nome: Agencia Nacional de Vigilancia Sanitaria
Dominio:  ctlivre.gov.br	Nome: Ministério da Ciência e Tecnologia
Dominio:  bancodeconteudos.gov.br	Nome: Ministerio da Cultura
Dominio:  bcc.gov.br	Nome: Ministerio da Cultura
Dominio:  cinemateca.gov.br	Nome: Ministerio da Cultura
Dominio:  ctav.gov.br	Nome: Ministerio da Cultura
Dominio:  brasilcentral.gov.br	Nome: Sec. de Estado de Plan. e Orçamento do DF
Dominio:  df.gov.br	Nome: Sec. de Estado de Plan. e Orçamento do DF
Dominio:  gdf.gov.br	Nome: Sec. de Estado de Plan. e Orçamento do DF
Dominio:  sp-trt.gov.br	Nome: Tribunal Regional do Trabalho da 2a Regiao
Dominio:  sptrt.gov.br	Nome: Tribunal Regional do Trabalho da 2a Regiao
Dominio:  trt-02.gov.br	Nome: Tribunal Regional do Trabalho da 2a Regiao
Dominio:  trt-sp.gov.br	Nome: Tribunal Regional do Trabalho da 2a Regiao
Dominio:  trt02.gov.br	Nome: Tribunal Regional do Trabalho da 2a Regiao
Dominio:  trt2.gov.br	Nome: Tribunal Regional do Trabalho da 2a Regiao
Dominio:  trtsp.gov.br	Nome: Tribunal Regional do Trabalho da 2a Regiao
Dominio:  trtwap.gov.br	Nome: Tribunal Regional do Trabalho da 2a Regiao
Dominio:  trt14.gov.br	Nome: TRIBUNAL REGIONAL DO TRABALHO-14a.REGIÃO
Dominio:  cenad.gov.br	Nome: MINISTERIO DA INTEGRACAO NACIONAL
Dominio:  defencil.gov.br	Nome: MINISTERIO DA INTEGRACAO NACIONAL
Dominio:  defesacivil.gov.br	Nome: MINISTERIO DA INTEGRACAO NACIONAL
Dominio:  integracao.gov.br	Nome: MINISTERIO DA INTEGRACAO NACIONAL
Dominio:  integracaosaofrancisco.gov.br	Nome: MINISTERIO DA INTEGRACAO NACIONAL
Dominio:  mi.gov.br	Nome: MINISTERIO DA INTEGRACAO NACIONAL
Dominio:  seminariodefencil.gov.br	Nome: MINISTERIO DA INTEGRACAO NACIONAL
Dominio:  mt.gov.br	Nome: ESTADO DE MATO GROSSO
Dominio:  go.gov.br	Nome: Secretaria de Gestão e Planejamento de Goiás
Dominio:  goias.gov.br	Nome: Secretaria de Gestão e Planejamento de Goiás
Dominio:  ans-saude.gov.br	Nome: Agencia Nacional de Saude Suplementar
Dominio:  ans.gov.br	Nome: Agencia Nacional de Saude Suplementar
Dominio:  anssaude.gov.br	Nome: Agencia Nacional de Saude Suplementar
Dominio:  saudesuplementar.gov.br	Nome: Agencia Nacional de Saude Suplementar
Dominio:  conter.gov.br	Nome: Conselho Nacional de Téc. em Radiologia - Conter
Dominio:  crtr01.gov.br	Nome: Conselho Regional de Tecnicos em Radiologia -01
Dominio:  trf1.gov.br	Nome: Tribunal Regional Federal da 1a Regiao
Dominio:  car.gov.br	Nome: INSTITUTO BRASILEIRO DO MEIO AMBIENTE
Dominio:  ibama.gov.br	Nome: INSTITUTO BRASILEIRO DO MEIO AMBIENTE
Dominio:  ibamanet.gov.br	Nome: INSTITUTO BRASILEIRO DO MEIO AMBIENTE
Dominio:  maisambiente.gov.br	Nome: INSTITUTO BRASILEIRO DO MEIO AMBIENTE
Dominio:  ibama-pi.gov.br	Nome: IBAMA - GERENCIA EXECUTIVA ESTADUAL
Dominio:  crbio5.gov.br	Nome: Conselho Regional de Biologia 5ª Região
Dominio:  cref-sp.gov.br	Nome: Conselho Regional de Educação Física do Est.de SP.
Dominio:  cref4-sp.gov.br	Nome: Conselho Regional de Educação Física do Est.de SP.
Dominio:  cref4.gov.br	Nome: Conselho Regional de Educação Física do Est.de SP.
Dominio:  cref4sp.gov.br	Nome: Conselho Regional de Educação Física do Est.de SP.
Dominio:  crefsp.gov.br	Nome: Conselho Regional de Educação Física do Est.de SP.
Dominio:  ce.gov.br	Nome: EMPRESA DE TECNOLOGIA DA INFORMACAO DO CEARA-ETICE
Dominio:  coren-df.gov.br	Nome: CONSELHO REGIONAL DE ENFERMAGEM DO DF
Dominio:  esmpu.gov.br	Nome: ESCOLA SUPERIOR DO MINISTÉRIO PÚBLICO DA UNIÃO
Dominio:  paranaeleitoral.gov.br	Nome: Tribunal Regional Eleitoral do Parana
Dominio:  tre-pr.gov.br	Nome: Tribunal Regional Eleitoral do Parana
Dominio:  ac.gov.br	Nome: SECRETARIA DE ESTADO DA GESTAO ADMINISTRATIVA - SG
Dominio:  acre.gov.br	Nome: SECRETARIA DE ESTADO DA GESTAO ADMINISTRATIVA - SG
Dominio:  acraiz.gov.br	Nome: Instituto Nacional de Tecnologia Informação - ITI
Dominio:  icpbrasil.gov.br	Nome: Instituto Nacional de Tecnologia Informação - ITI
Dominio:  iti.gov.br	Nome: Instituto Nacional de Tecnologia Informação - ITI
Dominio:  crbio-03.gov.br	Nome: Conselho Regional de Biologia - 3a. Região
Dominio:  crbio-3.gov.br	Nome: Conselho Regional de Biologia - 3a. Região
Dominio:  crbio-rs.gov.br	Nome: Conselho Regional de Biologia - 3a. Região
Dominio:  crbio-sc.gov.br	Nome: Conselho Regional de Biologia - 3a. Região
Dominio:  crbio03.gov.br	Nome: Conselho Regional de Biologia - 3a. Região
Dominio:  crbio3.gov.br	Nome: Conselho Regional de Biologia - 3a. Região
Dominio:  rsbr.gov.br	Nome: OBSERVATORIO NACIONAL
Dominio:  cetem.gov.br	Nome: CENTRO DE TECNOLOGIA MINERAL
Dominio:  linea.gov.br	Nome: Laboratório Nacional de Computação Científica
Dominio:  sibbr.gov.br	Nome: Laboratório Nacional de Computação Científica
Dominio:  biodiesel.gov.br	Nome: IBICT - MCTI
Dominio:  energiaheliotermica.gov.br	Nome: IBICT - MCTI
Dominio:  infosoc.gov.br	Nome: IBICT - MCTI
Dominio:  socinfo.gov.br	Nome: IBICT - MCTI
Dominio:  imprensanacional.gov.br	Nome: Imprensa Nacional/Presidência da República
Dominio:  ana.gov.br	Nome: Agência Nacional de Águas
Dominio:  cbh.gov.br	Nome: Agência Nacional de Águas
Dominio:  portaldasaguas.gov.br	Nome: Agência Nacional de Águas
Dominio:  snirh.gov.br	Nome: Agência Nacional de Águas
Dominio:  snisb.gov.br	Nome: Agência Nacional de Águas
Dominio:  dom.gov.br	Nome: Projeto Dom Helder Câmara
Dominio:  projetodomhelder.gov.br	Nome: Projeto Dom Helder Câmara
Dominio:  an.gov.br	Nome: Arquivo Nacional
Dominio:  arquivonacional.gov.br	Nome: Arquivo Nacional
Dominio:  cnarq.gov.br	Nome: Arquivo Nacional
Dominio:  conarq.gov.br	Nome: Arquivo Nacional
Dominio:  memoriasreveladas.gov.br	Nome: Arquivo Nacional
Dominio:  suframa.gov.br	Nome: SUPERINTENDÊNCIA DA ZONA FRANCA DE MANAUS
Dominio:  am.gov.br	Nome: PRODAM Processamento de Dados Amazonas S.A
Dominio:  emgea.gov.br	Nome: Empresa Gestora de Ativos - EMGEA
Dominio:  aleam.gov.br	Nome: ASSEMBLEIA LEGISLATIVA DO ESTADO DO AMAZONAS
Dominio:  tre-ro.gov.br	Nome: Tribunal Regional Eleitoral de Rondônia
Dominio:  creci-pa.gov.br	Nome: Conselho Regional de Corretores de Imóveis
Dominio:  creci-am.gov.br	Nome: CONSELHO REG DE CORRETORES DE IMOVEIS DO AMAZONAS
Dominio:  corenam.gov.br	Nome: CONSELHO REGIONAL DE ENFERMAGEM DO AMAZONAS
Dominio:  crmvpaap.gov.br	Nome: Conselho Regional de Medicina Veterinaria Para
Dominio:  ro.gov.br	Nome: Secretaria de Estado - SEPLAD - RO
Dominio:  altatv.gov.br	Nome: Centro de Tecnologia da Informação Renato Archer
Dominio:  cenpra.gov.br	Nome: Centro de Tecnologia da Informação Renato Archer
Dominio:  certics.gov.br	Nome: Centro de Tecnologia da Informação Renato Archer
Dominio:  ci-brasil.gov.br	Nome: Centro de Tecnologia da Informação Renato Archer
Dominio:  cti.gov.br	Nome: Centro de Tecnologia da Informação Renato Archer
Dominio:  ic-brazil.gov.br	Nome: Centro de Tecnologia da Informação Renato Archer
Dominio:  ancine.gov.br	Nome: Agencia Nacional do Cinema
Dominio:  dnit.gov.br	Nome: DNIT-DEPARTAMENTO NACIONAL DE INFRAEST DE TRANSPOR
Dominio:  antt.gov.br	Nome: Agência Nacional de Transportes Terrestres
Dominio:  tavbrasil.gov.br	Nome: Agência Nacional de Transportes Terrestres
Dominio:  antaq.gov.br	Nome: AGENCIA NACIONAL DE TRANSPORTES AQUAVIARIOS
Dominio:  crea-ro.gov.br	Nome: Conselho Regional de Engenharia e Agronomia de RO
Dominio:  crearo.gov.br	Nome: Conselho Regional de Engenharia e Agronomia de RO
Dominio:  comiteamazonia.gov.br	Nome: Superintedência de Denvolvimento da Amazônia
Dominio:  sudam.gov.br	Nome: Superintedência de Denvolvimento da Amazônia
Dominio:  ahimor.gov.br	Nome: Administracao das Hidrovias da Amazonia Oriental
Dominio:  ahitar.gov.br	Nome: AHITAR - ADMINISTRACAO DAS HIDROVIAS DO TOCANTINS
Dominio:  cdp-ahitar.gov.br	Nome: AHITAR - ADMINISTRACAO DAS HIDROVIAS DO TOCANTINS
Dominio:  cft.gov.br	Nome: Conselho de Teologos do Brasil - Coteb
Dominio:  pa.gov.br	Nome: PRODEPA - Processamento de Dados do Pará
Dominio:  prodepa.gov.br	Nome: PRODEPA - Processamento de Dados do Pará
Dominio:  etfto.gov.br	Nome: Escola Técnica Federal de Palmas - TO
Dominio:  ada.gov.br	Nome: Superintedência do Denvolvimento da Amazônia
Dominio:  adene.gov.br	Nome: Agência de Desenvolvimento do Nordeste
Dominio:  jfpr.gov.br	Nome: Justiça Federal de Primeiro Grau no Parana
Dominio:  jfes.gov.br	Nome: Justiça Federal de 1º Grau no Espírito Santo
Dominio:  jfceara.gov.br	Nome: JUSTICA FED DE PRIM INST SECAO JUD DO CEARA
Dominio:  jfrj.gov.br	Nome: JUSTICA FEDERAL DE PRIMEIRO GRAU NO RIO DE JANEIR
Dominio:  jfsc.gov.br	Nome: Justica Federal de Primeiro Grau em Santa Catarina
Dominio:  eproc-pr.gov.br	Nome: Justica Federal de Primeiro Grau no RS
Dominio:  eproc-rs.gov.br	Nome: Justica Federal de Primeiro Grau no RS
Dominio:  eproc-sc.gov.br	Nome: Justica Federal de Primeiro Grau no RS
Dominio:  eproc.gov.br	Nome: Justica Federal de Primeiro Grau no RS
Dominio:  jef-pr.gov.br	Nome: Justica Federal de Primeiro Grau no RS
Dominio:  jef-rs.gov.br	Nome: Justica Federal de Primeiro Grau no RS
Dominio:  jef-sc.gov.br	Nome: Justica Federal de Primeiro Grau no RS
Dominio:  jfrs.gov.br	Nome: Justica Federal de Primeiro Grau no RS
Dominio:  peticaoeletronica.gov.br	Nome: Justica Federal de Primeiro Grau no RS
Dominio:  sjrs.gov.br	Nome: Justica Federal de Primeiro Grau no RS
Dominio:  turismoacessivel.gov.br	Nome: Ministério do Turismo
Dominio:  viajamais.gov.br	Nome: Ministério do Turismo
Dominio:  cidades.gov.br	Nome: Ministério das Cidades
Dominio:  pmss.gov.br	Nome: Ministério das Cidades
Dominio:  simulaminhacasaminhavida.gov.br	Nome: Ministério das Cidades
Dominio:  snis.gov.br	Nome: Ministério das Cidades
Dominio:  cdv.gov.br	Nome: Secretaria de Direitos Humanos
Dominio:  certidaodenascimento.gov.br	Nome: Secretaria de Direitos Humanos
Dominio:  clique100.gov.br	Nome: Secretaria de Direitos Humanos
Dominio:  desaparecidos.gov.br	Nome: Secretaria de Direitos Humanos
Dominio:  direitosdacrianca.gov.br	Nome: Secretaria de Direitos Humanos
Dominio:  direitoshumanos.gov.br	Nome: Secretaria de Direitos Humanos
Dominio:  disque100.gov.br	Nome: Secretaria de Direitos Humanos
Dominio:  humanizaredes.gov.br	Nome: Secretaria de Direitos Humanos
Dominio:  obscriancaeadolescente.gov.br	Nome: Secretaria de Direitos Humanos
Dominio:  pessoacomdeficiencia.gov.br	Nome: Secretaria de Direitos Humanos
Dominio:  ppcaam.gov.br	Nome: Secretaria de Direitos Humanos
Dominio:  registrocivil.gov.br	Nome: Secretaria de Direitos Humanos
Dominio:  sdh.gov.br	Nome: Secretaria de Direitos Humanos
Dominio:  sedh.gov.br	Nome: Secretaria de Direitos Humanos
Dominio:  sipia.gov.br	Nome: Secretaria de Direitos Humanos
Dominio:  viversemlimite.gov.br	Nome: Secretaria de Direitos Humanos
Dominio:  xn--certidodenascimento-0vb.gov.br	Nome: Secretaria de Direitos Humanos
Dominio:  mpa.gov.br	Nome: Ministério da Pesca e Aquicultura
Dominio:  pescabrasil.gov.br	Nome: Ministério da Pesca e Aquicultura
Dominio:  preps.gov.br	Nome: Ministério da Pesca e Aquicultura
Dominio:  renaqua.gov.br	Nome: Ministério da Pesca e Aquicultura
Dominio:  seap.gov.br	Nome: Ministério da Pesca e Aquicultura
Dominio:  mulheres.gov.br	Nome: Secretaria Especial de Politícas para as Mulheres
Dominio:  politicasmulheres.gov.br	Nome: Secretaria Especial de Politícas para as Mulheres
Dominio:  sepm.gov.br	Nome: Secretaria Especial de Politícas para as Mulheres
Dominio:  spm.gov.br	Nome: Secretaria Especial de Politícas para as Mulheres
Dominio:  spmulheres.gov.br	Nome: Secretaria Especial de Politícas para as Mulheres
Dominio:  assistenciasocial.gov.br	Nome: DTI/SE/MDS E COMBATE A FOME
Dominio:  brasilsaudavelesustentavel.gov.br	Nome: DTI/SE/MDS E COMBATE A FOME
Dominio:  caisan.gov.br	Nome: DTI/SE/MDS E COMBATE A FOME
Dominio:  coletasolidaria.gov.br	Nome: DTI/SE/MDS E COMBATE A FOME
Dominio:  combateafome.gov.br	Nome: DTI/SE/MDS E COMBATE A FOME
Dominio:  comprasagriculturafamiliar.gov.br	Nome: DTI/SE/MDS E COMBATE A FOME
Dominio:  desenvolvimentosocial.gov.br	Nome: DTI/SE/MDS E COMBATE A FOME
Dominio:  fimdotrabalhoinfantil.gov.br	Nome: DTI/SE/MDS E COMBATE A FOME
Dominio:  mds.gov.br	Nome: DTI/SE/MDS E COMBATE A FOME
Dominio:  tre-mt.gov.br	Nome: Tribunal Regional Eleitoral de Mato Grosso
Dominio:  acessoainformacao.gov.br	Nome: CONTROLADORIA-GERAL DA UNIÃO
Dominio:  acessoinformacao.gov.br	Nome: CONTROLADORIA-GERAL DA UNIÃO
Dominio:  cgu.gov.br	Nome: CONTROLADORIA-GERAL DA UNIÃO
Dominio:  contracorrupcao.gov.br	Nome: CONTROLADORIA-GERAL DA UNIÃO
Dominio:  controladoria.gov.br	Nome: CONTROLADORIA-GERAL DA UNIÃO
Dominio:  controle.gov.br	Nome: CONTROLADORIA-GERAL DA UNIÃO
Dominio:  e-sic.gov.br	Nome: CONTROLADORIA-GERAL DA UNIÃO
Dominio:  esic.gov.br	Nome: CONTROLADORIA-GERAL DA UNIÃO
Dominio:  info.gov.br	Nome: CONTROLADORIA-GERAL DA UNIÃO
Dominio:  informacao.gov.br	Nome: CONTROLADORIA-GERAL DA UNIÃO
Dominio:  juntoscontracorrupcao.gov.br	Nome: CONTROLADORIA-GERAL DA UNIÃO
Dominio:  lai.gov.br	Nome: CONTROLADORIA-GERAL DA UNIÃO
Dominio:  ouvidoria.gov.br	Nome: CONTROLADORIA-GERAL DA UNIÃO
Dominio:  ouvidorias.gov.br	Nome: CONTROLADORIA-GERAL DA UNIÃO
Dominio:  portaldatransparencia.gov.br	Nome: CONTROLADORIA-GERAL DA UNIÃO
Dominio:  portaltransparencia.gov.br	Nome: CONTROLADORIA-GERAL DA UNIÃO
Dominio:  sic.gov.br	Nome: CONTROLADORIA-GERAL DA UNIÃO
Dominio:  todoscontracorrupcao.gov.br	Nome: CONTROLADORIA-GERAL DA UNIÃO
Dominio:  todosjuntoscontracorrupcao.gov.br	Nome: CONTROLADORIA-GERAL DA UNIÃO
Dominio:  transparencia.gov.br	Nome: CONTROLADORIA-GERAL DA UNIÃO
Dominio:  transparenciapublica.gov.br	Nome: CONTROLADORIA-GERAL DA UNIÃO
Dominio:  creciro.gov.br	Nome: CONSELHO REGIONAL DE CORRETORES DE IMOVEIS 24 REG
Dominio:  igualdaderacial.gov.br	Nome: SECRETARIA ESPECIAL DE POLITICAS DE PROMOCAO DA IG
Dominio:  portaldaigualdade.gov.br	Nome: SECRETARIA ESPECIAL DE POLITICAS DE PROMOCAO DA IG
Dominio:  promocaodaigualdaderacial.gov.br	Nome: SECRETARIA ESPECIAL DE POLITICAS DE PROMOCAO DA IG
Dominio:  seppir.gov.br	Nome: SECRETARIA ESPECIAL DE POLITICAS DE PROMOCAO DA IG
Dominio:  pe.gov.br	Nome: AGENCIA ESTADUAL DE TECNOLOGIA DA INFORMACAO - ATI
Dominio:  pernambuco.gov.br	Nome: AGENCIA ESTADUAL DE TECNOLOGIA DA INFORMACAO - ATI
Dominio:  corenma.gov.br	Nome: Conselho Regional de Enfermagem - COREN/MA
Dominio:  codomar.gov.br	Nome: Codomar - Companhia Docas do Maranhao
Dominio:  ahinor.gov.br	Nome: ADMINISTRAÇÃO DAS HIDROVIAS DO NORDESTE - AHINOR
Dominio:  ahimoc.gov.br	Nome: Admin. das Hidrovias da Amazonia Ocidental
Dominio:  ahsul.gov.br	Nome: COMPANHIA DOCAS DO MARANHAO - CODOMAR
Dominio:  coredopiaui.gov.br	Nome: Conselho Regional dos Representantes Coml. do Piau
Dominio:  epe.gov.br	Nome: Empresa de Pesquisa Energética
Dominio:  sipam.gov.br	Nome: Centro Gestor e Op. Sist. de Proteção da Amazonia
Dominio:  banconordeste.gov.br	Nome: BANCO DO NORDESTE DO BRASIL S/A
Dominio:  bnb.gov.br	Nome: BANCO DO NORDESTE DO BRASIL S/A
Dominio:  crediamigo.gov.br	Nome: BANCO DO NORDESTE DO BRASIL S/A
Dominio:  crescenordeste.gov.br	Nome: BANCO DO NORDESTE DO BRASIL S/A
Dominio:  faroldodesenvolvimento.gov.br	Nome: BANCO DO NORDESTE DO BRASIL S/A
Dominio:  nordestedigital.gov.br	Nome: BANCO DO NORDESTE DO BRASIL S/A
Dominio:  nordesteeletronico.gov.br	Nome: BANCO DO NORDESTE DO BRASIL S/A
Dominio:  nordestenegocios.gov.br	Nome: BANCO DO NORDESTE DO BRASIL S/A
Dominio:  bancodonordeste.gov.br	Nome: BANCO DO NORDESTE DO BRASIL S/A
Dominio:  previc.gov.br	Nome: PREVIC Sup. Nacional de Previdência Complementar
Dominio:  cnj.gov.br	Nome: Conselho Nacional de Justiça
Dominio:  projovem.gov.br	Nome: Secretaria Nacional da Juventude
Dominio:  projovemurbano.gov.br	Nome: Secretaria Nacional da Juventude
Dominio:  hemobras.gov.br	Nome: Empresa Brasileira de Hemoderivados e Biotecnologi
Dominio:  coren-pb.gov.br	Nome: CONSELHO REGIONAL DE ENFERMAGEM DA PARAIBA
Dominio:  corenpb.gov.br	Nome: CONSELHO REGIONAL DE ENFERMAGEM DA PARAIBA
Dominio:  acs.gov.br	Nome: ALCANTARA CYCLONE SPACE - BINACIONAL
Dominio:  crbio-7.gov.br	Nome: conselho regional de biologia da setima região
Dominio:  crbio-pr.gov.br	Nome: conselho regional de biologia da setima região
Dominio:  crbio07.gov.br	Nome: conselho regional de biologia da setima região
Dominio:  crbio7.gov.br	Nome: conselho regional de biologia da setima região
Dominio:  crbiopr.gov.br	Nome: conselho regional de biologia da setima região
Dominio:  crbio06.gov.br	Nome: Conselho Regional de Biologia 6ª Região
Dominio:  anac.gov.br	Nome: Agência Nacional de Aviação Civil - ANAC
Dominio:  ceara.gov.br	Nome: Secretaria da Administração
Dominio:  crefono8.gov.br	Nome: Conselho Regional de Fonoaudiologia 8a Regiao
Dominio:  rn.gov.br	Nome: Governo do Estado do Rio Grande do Norte
Dominio:  coren-mt.gov.br	Nome: CONSELHO REGIONAL DE ENFERMAGEM DE MATO GROSSO
Dominio:  rni.gov.br	Nome: REDE NORTERIOGRANDESE DE INFORMATICA - RNI
Dominio:  projud.gov.br	Nome: TRIBUNAL DE JUSTIÇA DO ESTADO DO RN
Dominio:  tjrn.gov.br	Nome: TRIBUNAL DE JUSTIÇA DO ESTADO DO RN
Dominio:  crmvrn.gov.br	Nome: Conselho Regional de Medicina Veterinária do RN
Dominio:  biodiversidade.gov.br	Nome: INSTITUTO CHICO MENDES DE CONS. DA BIODIVERSIDADE
Dominio:  cemave.gov.br	Nome: INSTITUTO CHICO MENDES DE CONS. DA BIODIVERSIDADE
Dominio:  chicomendes.gov.br	Nome: INSTITUTO CHICO MENDES DE CONS. DA BIODIVERSIDADE
Dominio:  icmbio.gov.br	Nome: INSTITUTO CHICO MENDES DE CONS. DA BIODIVERSIDADE
Dominio:  institutochicomendes.gov.br	Nome: INSTITUTO CHICO MENDES DE CONS. DA BIODIVERSIDADE
Dominio:  pi.gov.br	Nome: Agência de Tecnologia da Informação do Piauí ATI
Dominio:  portosempapel.gov.br	Nome: SECRETARIA DE PORTOS DA PRESIDENCIA DA REPUBLICA
Dominio:  agenciabrasil.gov.br	Nome: EMPRESA BRASIL DE COMUNICACAO S.A. - EBC
Dominio:  avozdobrasil.gov.br	Nome: EMPRESA BRASIL DE COMUNICACAO S.A. - EBC
Dominio:  nbr.gov.br	Nome: EMPRESA BRASIL DE COMUNICACAO S.A. - EBC
Dominio:  portalbrasil.gov.br	Nome: EMPRESA BRASIL DE COMUNICACAO S.A. - EBC
Dominio:  radiobras.gov.br	Nome: EMPRESA BRASIL DE COMUNICACAO S.A. - EBC
Dominio:  voz.gov.br	Nome: EMPRESA BRASIL DE COMUNICACAO S.A. - EBC
Dominio:  vozdobrasil.gov.br	Nome: EMPRESA BRASIL DE COMUNICACAO S.A. - EBC
Dominio:  pb.gov.br	Nome: Companhia de Processamento de Dados da Paraiba
Dominio:  brasilpresente.gov.br	Nome: Secretaria de Comunicação Social
Dominio:  comunicacaosocial.gov.br	Nome: Secretaria de Comunicação Social
Dominio:  confecom.gov.br	Nome: Secretaria de Comunicação Social
Dominio:  convergenciademidias.gov.br	Nome: Secretaria de Comunicação Social
Dominio:  cop.gov.br	Nome: Secretaria de Comunicação Social
Dominio:  cop15.gov.br	Nome: Secretaria de Comunicação Social
Dominio:  cop15brasil.gov.br	Nome: Secretaria de Comunicação Social
Dominio:  cop15brazil.gov.br	Nome: Secretaria de Comunicação Social
Dominio:  emquestao.gov.br	Nome: Secretaria de Comunicação Social
Dominio:  fatoseboatos.gov.br	Nome: Secretaria de Comunicação Social
Dominio:  genero.gov.br	Nome: Secretaria de Comunicação Social
Dominio:  historiasdobrasil.gov.br	Nome: Secretaria de Comunicação Social
Dominio:  portalpadrao.gov.br	Nome: Secretaria de Comunicação Social
Dominio:  portalplanalto.gov.br	Nome: Secretaria de Comunicação Social
Dominio:  secom.gov.br	Nome: Secretaria de Comunicação Social
Dominio:  somostodosbrasil.gov.br	Nome: Secretaria de Comunicação Social
Dominio:  renapi.gov.br	Nome: Instituto Federal de Brasília
Dominio:  creci-pb.gov.br	Nome: Conselho Regional de Corretores de Imóveis 21ª Reg
Dominio:  gsi.gov.br	Nome: GABINETE DE SEGURANCA INSTITUCIONAL DA PRESIDENCIA
Dominio:  creci-ce.gov.br	Nome: Conselho Regional de Corretores de Imoveis do CE
Dominio:  etfc.gov.br	Nome: ESCOLA TÉCNICA FEDERAL DE CANOAS
Dominio:  crqxx.gov.br	Nome: CONSELHO REGIONAL DE QUIMICA 20 REGIAO
Dominio:  fundaj.gov.br	Nome: FUNDACAO JOAQUIM NABUCO
Dominio:  casamilitar.gov.br	Nome: SECRETARIA DE GOVERNO DA PRESIDENCIA DA REPUBLICA
Dominio:  dialogabrasil.gov.br	Nome: SECRETARIA DE GOVERNO DA PRESIDENCIA DA REPUBLICA
Dominio:  governo.gov.br	Nome: SECRETARIA DE GOVERNO DA PRESIDENCIA DA REPUBLICA
Dominio:  participa.gov.br	Nome: SECRETARIA DE GOVERNO DA PRESIDENCIA DA REPUBLICA
Dominio:  participe.gov.br	Nome: SECRETARIA DE GOVERNO DA PRESIDENCIA DA REPUBLICA
Dominio:  participo.gov.br	Nome: SECRETARIA DE GOVERNO DA PRESIDENCIA DA REPUBLICA
Dominio:  secgeral.gov.br	Nome: SECRETARIA DE GOVERNO DA PRESIDENCIA DA REPUBLICA
Dominio:  secretaria-geral.gov.br	Nome: SECRETARIA DE GOVERNO DA PRESIDENCIA DA REPUBLICA
Dominio:  secretariadegoverno.gov.br	Nome: SECRETARIA DE GOVERNO DA PRESIDENCIA DA REPUBLICA
Dominio:  secretariageral.gov.br	Nome: SECRETARIA DE GOVERNO DA PRESIDENCIA DA REPUBLICA
Dominio:  segov.gov.br	Nome: SECRETARIA DE GOVERNO DA PRESIDENCIA DA REPUBLICA
Dominio:  sg.gov.br	Nome: SECRETARIA DE GOVERNO DA PRESIDENCIA DA REPUBLICA
Dominio:  sgov.gov.br	Nome: SECRETARIA DE GOVERNO DA PRESIDENCIA DA REPUBLICA
Dominio:  crtr17.gov.br	Nome: Conselho Regional de Técnicos em Radiologia 17ª Rg
Dominio:  crtr18.gov.br	Nome: CONSELHO REG DOS TECN EM RADIOLOGIA 18 REGIAO
Dominio:  ceitec.gov.br	Nome: Centro Nacional de Tecnologia Eletronica Avancada
Dominio:  inovaif.gov.br	Nome: Instituto Federal de Educação, Ciências e Tecnolog
Dominio:  sudene.gov.br	Nome: SUPERINTENDENCIA DO DESENVOLVIMENTO DO NORDESTE -
Dominio:  ibram.gov.br	Nome: Instituto Brasileiro de Museus - IBRAM
Dominio:  museulasarsegall.gov.br	Nome: Instituto Brasileiro de Museus - IBRAM
Dominio:  museus.gov.br	Nome: Instituto Brasileiro de Museus - IBRAM
Dominio:  museuvictormeirelles.gov.br	Nome: Instituto Brasileiro de Museus - IBRAM
Dominio:  inma.gov.br	Nome: MUSEU DE BIOLOGIA PROFESSOR MELLO LEITAO
Dominio:  institutodamataatlantica.gov.br	Nome: MUSEU DE BIOLOGIA PROFESSOR MELLO LEITAO
Dominio:  museudebiologiamelloleitao.gov.br	Nome: MUSEU DE BIOLOGIA PROFESSOR MELLO LEITAO
Dominio:  creci-pe.gov.br	Nome: CONSELHO REGIONAL DE CORRETORES DE IMOVEIS 7 REGIA
Dominio:  crecipe.gov.br	Nome: CONSELHO REGIONAL DE CORRETORES DE IMOVEIS 7 REGIA
Dominio:  emprel.gov.br	Nome: EMPREL - EMPRESA MUNICIPAL DE INFORMATICA
Dominio:  tjpe.gov.br	Nome: TRIBUNAL DE JUSTICA DO ESTADO DE PERNAMBUCO
Dominio:  cnmp.gov.br	Nome: CONSELHO NACIONAL DO MINISTERIO PUBLICO
Dominio:  dialogosfederativos.gov.br	Nome: Subchefia de Assuntos Federativos
Dominio:  relacoesinstitucionais.gov.br	Nome: SECRETARIA DE RELACOES INSTITUCIONAIS DA PRESIDENC
Dominio:  sri.gov.br	Nome: SECRETARIA DE RELACOES INSTITUCIONAIS DA PRESIDENC
Dominio:  coren-pe.gov.br	Nome: Conselho Regional de Enfermagem de Pernambuco
Dominio:  crtr19.gov.br	Nome: CONSELHO REGIONAL DE TECNICOS EM RADIOLOGIA 19
Dominio:  creci-al.gov.br	Nome: Conselho Regional de Corretores de Imoveis - AL
Dominio:  eafspb.gov.br	Nome: ESCOLA AGROTECNICA FEDERAL DE SOUSA
Dominio:  se.gov.br	Nome: EMPRESA SERGIPANA DE TECNOLOGIA DA INFORMAÇÃO
Dominio:  creci-se.gov.br	Nome: CONSELHO REGIONAL CORRETORES DE IMOVEIS 16 REGIAO
Dominio:  crecise.gov.br	Nome: CONSELHO REGIONAL CORRETORES DE IMOVEIS 16 REGIAO
Dominio:  aviacao.gov.br	Nome: Secretaria de Aviação Civil
Dominio:  aviacaocivil.gov.br	Nome: Secretaria de Aviação Civil
Dominio:  ba.gov.br	Nome: Cia. de Processamento de Dados do Estado da Bahia
Dominio:  prodeb.gov.br	Nome: Cia. de Processamento de Dados do Estado da Bahia
Dominio:  crbm5.gov.br	Nome: Conselho Regional de Biomedicina 5ª Região
Dominio:  sudeco.gov.br	Nome: SUPERINTENDÊNCIA DO DESENVOLVIMENTO DO CENTRO-OEST
Dominio:  apo.gov.br	Nome: Autoridade Pública Olimpica
Dominio:  crq7.gov.br	Nome: Conselho Regional de Quimica Vii Região
Dominio:  cra-amrr.gov.br	Nome: CONSELHO REGIONAL DE ADMINISTRAÇÃO DO AMAZONAS
Dominio:  ahsfra.gov.br	Nome: Administração da Hidrovia do São Francisco
Dominio:  arquitetura.gov.br	Nome: Conselho de Arquitetura e Urbanismo do Brasil
Dominio:  cauac.gov.br	Nome: Conselho de Arquitetura e Urbanismo do Brasil
Dominio:  caual.gov.br	Nome: Conselho de Arquitetura e Urbanismo do Brasil
Dominio:  cauam.gov.br	Nome: Conselho de Arquitetura e Urbanismo do Brasil
Dominio:  cauap.gov.br	Nome: Conselho de Arquitetura e Urbanismo do Brasil
Dominio:  cauba.gov.br	Nome: Conselho de Arquitetura e Urbanismo do Brasil
Dominio:  caubr.gov.br	Nome: Conselho de Arquitetura e Urbanismo do Brasil
Dominio:  cauce.gov.br	Nome: Conselho de Arquitetura e Urbanismo do Brasil
Dominio:  caudf.gov.br	Nome: Conselho de Arquitetura e Urbanismo do Brasil
Dominio:  caues.gov.br	Nome: Conselho de Arquitetura e Urbanismo do Brasil
Dominio:  caugo.gov.br	Nome: Conselho de Arquitetura e Urbanismo do Brasil
Dominio:  cauma.gov.br	Nome: Conselho de Arquitetura e Urbanismo do Brasil
Dominio:  caumg.gov.br	Nome: Conselho de Arquitetura e Urbanismo do Brasil
Dominio:  caums.gov.br	Nome: Conselho de Arquitetura e Urbanismo do Brasil
Dominio:  caumt.gov.br	Nome: Conselho de Arquitetura e Urbanismo do Brasil
Dominio:  caupa.gov.br	Nome: Conselho de Arquitetura e Urbanismo do Brasil
Dominio:  caupb.gov.br	Nome: Conselho de Arquitetura e Urbanismo do Brasil
Dominio:  caupe.gov.br	Nome: Conselho de Arquitetura e Urbanismo do Brasil
Dominio:  caupi.gov.br	Nome: Conselho de Arquitetura e Urbanismo do Brasil
Dominio:  caupr.gov.br	Nome: Conselho de Arquitetura e Urbanismo do Brasil
Dominio:  caurj.gov.br	Nome: Conselho de Arquitetura e Urbanismo do Brasil
Dominio:  caurn.gov.br	Nome: Conselho de Arquitetura e Urbanismo do Brasil
Dominio:  cauro.gov.br	Nome: Conselho de Arquitetura e Urbanismo do Brasil
Dominio:  caurr.gov.br	Nome: Conselho de Arquitetura e Urbanismo do Brasil
Dominio:  caurs.gov.br	Nome: Conselho de Arquitetura e Urbanismo do Brasil
Dominio:  causc.gov.br	Nome: Conselho de Arquitetura e Urbanismo do Brasil
Dominio:  cause.gov.br	Nome: Conselho de Arquitetura e Urbanismo do Brasil
Dominio:  causp.gov.br	Nome: Conselho de Arquitetura e Urbanismo do Brasil
Dominio:  cauto.gov.br	Nome: Conselho de Arquitetura e Urbanismo do Brasil
Dominio:  ebserh.gov.br	Nome: EMPRESA BRASILEIRA DE SERV HOSPITALARES - EBSERH
Dominio:  eusoumaismedico.gov.br	Nome: EMPRESA BRASILEIRA DE SERV HOSPITALARES - EBSERH
Dominio:  eusoumaismedicos.gov.br	Nome: EMPRESA BRASILEIRA DE SERV HOSPITALARES - EBSERH
Dominio:  maismedico.gov.br	Nome: EMPRESA BRASILEIRA DE SERV HOSPITALARES - EBSERH
Dominio:  maismedicos.gov.br	Nome: EMPRESA BRASILEIRA DE SERV HOSPITALARES - EBSERH
Dominio:  soumaismedico.gov.br	Nome: EMPRESA BRASILEIRA DE SERV HOSPITALARES - EBSERH
Dominio:  soumaismedicos.gov.br	Nome: EMPRESA BRASILEIRA DE SERV HOSPITALARES - EBSERH
Dominio:  creciba.gov.br	Nome: CRECI 9º Regiao/Ba
Dominio:  ms.gov.br	Nome: Governo do Estado de Mato Grosso do Sul
Dominio:  coren-ba.gov.br	Nome: Conselho Regional de Enfermagem da Bahia
Dominio:  epl.gov.br	Nome: Empresa de Planejamento e Logística S.A - EPL
Dominio:  logisticabrasil.gov.br	Nome: Empresa de Planejamento e Logística S.A - EPL
Dominio:  logisticsbrazil.gov.br	Nome: Empresa de Planejamento e Logística S.A - EPL
Dominio:  eafcatu.gov.br	Nome: Escola Agrotécnica Federal de Catu
Dominio:  crmvmg.gov.br	Nome: Cons. Reg. de Medicina Veterinaria do Est. de MG
Dominio:  mg.gov.br	Nome: COMPANHIA DE TECNOLOGIA DA INFORMAÇÃO ESTADO MG
Dominio:  netminas.gov.br	Nome: COMPANHIA DE TECNOLOGIA DA INFORMAÇÃO ESTADO MG
Dominio:  prodemge.gov.br	Nome: COMPANHIA DE TECNOLOGIA DA INFORMAÇÃO ESTADO MG
Dominio:  epamigcaldas.gov.br	Nome: Empresa de Pesquisa Agrop. de Minas Gerais
Dominio:  casemg.gov.br	Nome: Cia. de Armazéns e Silos do Estado de Minas Gerais
Dominio:  ruralminas.gov.br	Nome: Fundação Rural Mineira - Ruralminas
Dominio:  funpresp-exe.gov.br	Nome: FUNDAÇÃO PREVIDÊNCIA COMPLEMENTAR SERVIDOR PUBLICO
Dominio:  funpresp.gov.br	Nome: FUNDAÇÃO PREVIDÊNCIA COMPLEMENTAR SERVIDOR PUBLICO
Dominio:  igam.gov.br	Nome: Instituto Mineiro de Gestão das Águas
Dominio:  ipsm.gov.br	Nome: INSTITUTO DE PREVIDENCIA DOS SERVIDORES MILITARES
Dominio:  fjp.gov.br	Nome: FUNDACAO JOAO PINHEIRO
Dominio:  crecimg.gov.br	Nome: Conselho Regional de Corretores de Imoveis
Dominio:  alemg.gov.br	Nome: ASSEMBLEIA LEGISLATIVA DE MINAS GERAIS
Dominio:  almg.gov.br	Nome: ASSEMBLEIA LEGISLATIVA DE MINAS GERAIS
Dominio:  abgf.gov.br	Nome: Agência Brasileira Gestora de F G e G SA
Dominio:  pbh.gov.br	Nome: Emp. Informat. Informaçao Mun. BH/SA
Dominio:  ppsa.gov.br	Nome: Empresa Brasileira de Administração de Petroleo de
Dominio:  presalpetroleo.gov.br	Nome: Empresa Brasileira de Administração de Petroleo de
Dominio:  amazul.gov.br	Nome: Amazônia Azul Tecnologias de Defesa S.A. - Amazul
Dominio:  tjmg.gov.br	Nome: TRIBUNAL DE JUSTIÇA DO ESTADO DE MINAS GERAIS
Dominio:  coren-mg.gov.br	Nome: CONSELHO REGIONAL DE ENFERMAGEM DE MINAS GERAIS
Dominio:  corenmg.gov.br	Nome: CONSELHO REGIONAL DE ENFERMAGEM DE MINAS GERAIS
Dominio:  crbio08.gov.br	Nome: CONSELHO REGIONAL DE BIOLOGIA 8 REGIAO
Dominio:  crbio8.gov.br	Nome: CONSELHO REGIONAL DE BIOLOGIA 8 REGIAO
Dominio:  eletrofurnas.gov.br	Nome: Furnas Centrais Elétricas S.A.
Dominio:  furnas.gov.br	Nome: Furnas Centrais Elétricas S.A.
Dominio:  crefito16.gov.br	Nome: Conselho Regional de Fisioterapia e Terapia Ocupac
Dominio:  trt-ma.gov.br	Nome: TRIBUNAL REGIONAL DO TRABALHO DA 16A. REGIAO
Dominio:  trt16.gov.br	Nome: TRIBUNAL REGIONAL DO TRABALHO DA 16A. REGIAO
Dominio:  mtps.gov.br	Nome: Ministério do Trabalho e Previdência Social
Dominio:  mmirjdh.gov.br	Nome: Min das Mulheres, Igualdade Racial, Juv. e Dir Hum
Dominio:  trf5.gov.br	Nome: Tribunal Regional Federal
Dominio:  crbm2.gov.br	Nome: Conselho Regional de Biomedicina em PE (2ª Regiao)
Dominio:  corenms.gov.br	Nome: CONSELHO REGIONAL DE ENFERMAGEM DE MS
Dominio:  eafa-to.gov.br	Nome: Escola Agrotecnica Federal de Araguatins
Dominio:  ceasa.gov.br	Nome: COMPANHIA NACIONAL DE ABASTECIMENTO
Dominio:  conab.gov.br	Nome: COMPANHIA NACIONAL DE ABASTECIMENTO
Dominio:  iphan.gov.br	Nome: Instituto do Patrimônio Histórico e Artístico Nac.
Dominio:  capoeira.gov.br	Nome: INSTITUTO DO PATRIMONIO HISTORICO E ARTISTICO NACI
Dominio:  mls.gov.br	Nome: IPHAN/Museu Lasar Segall
Dominio:  museuimperial.gov.br	Nome: Museu Imperial
Dominio:  mnba.gov.br	Nome: Museu Nacional de Belas Artes
Dominio:  museudainconfidencia.gov.br	Nome: IPHAN - MUSEU DA INCONFIDÊNCIA
Dominio:  cnfcp.gov.br	Nome: Centro Nacional de Folclore e Cultura Popular
Dominio:  crbm3.gov.br	Nome: Conselho Regional de Biomedicina
Dominio:  ctac.gov.br	Nome: FUNDAÇÃO NACIONAL DE ARTES
Dominio:  decine.gov.br	Nome: FUNDAÇÃO NACIONAL DE ARTES
Dominio:  funarte.gov.br	Nome: FUNDAÇÃO NACIONAL DE ARTES
Dominio:  apec.gov.br	Nome: FUNDAÇÃO NACIONAL DE SAÚDE
Dominio:  fns.gov.br	Nome: FUNDAÇÃO NACIONAL DE SAÚDE
Dominio:  funasa.gov.br	Nome: FUNDAÇÃO NACIONAL DE SAÚDE
Dominio:  fns-es.gov.br	Nome: Fundação Nacional de Saúde
Dominio:  fns-sc.gov.br	Nome: FUNDACAO NACIONAL DE SAUDE - COORDENAÇÃO REGIONAL
Dominio:  funasa-sc.gov.br	Nome: FUNDACAO NACIONAL DE SAUDE - COORDENAÇÃO REGIONAL
Dominio:  fnsms.gov.br	Nome: FUNDAÇÃO NACIONAL DE SAUDE
Dominio:  mpu.gov.br	Nome: Ministerio Publico da Uniao
Dominio:  ministeriopublicodf.gov.br	Nome: Ministério Público do DF e Territórios
Dominio:  mp-df.gov.br	Nome: Ministério Público do DF e Territórios
Dominio:  mpdf.gov.br	Nome: Ministério Público do DF e Territórios
Dominio:  mpdft.gov.br	Nome: Ministério Público do DF e Territórios
Dominio:  mpm.gov.br	Nome: MINISTERIO PUBLICO MILITAR
Dominio:  mpt.gov.br	Nome: MINISTERIO PUBLICO DO TRABALHO
Dominio:  prap.gov.br	Nome: Procuradoria da Republica no Estado do Amapa
Dominio:  focco-pb.gov.br	Nome: Procuradoria da República na Paraíba
Dominio:  foccopb.gov.br	Nome: Procuradoria da República na Paraíba
Dominio:  prsc.gov.br	Nome: PROCURADORIA DA REPUBLICA EM SANTA CATARINA
Dominio:  prt3.gov.br	Nome: PROCURADORIA REGIONAL DO TRABALHO 3a REGIAO
Dominio:  prt4.gov.br	Nome: Procuradoria Regional do Trabalho - 4º Regiao
Dominio:  prt6.gov.br	Nome: Procuradoria Regional do Trabalho - 6a Regiao
Dominio:  prt8.gov.br	Nome: Procuradoria Regional do Trabalho da 8a. Região
Dominio:  prt16.gov.br	Nome: PROCURADORIA REGIONAL DO TRABALHO DA 16a REGIAO
Dominio:  mpf.gov.br	Nome: MINISTERIO PUBLICO FEDERAL - PROCURADORIA GERAL DA
Dominio:  pgr.gov.br	Nome: MINISTERIO PUBLICO FEDERAL - PROCURADORIA GERAL DA
Dominio:  prt21.gov.br	Nome: Procuradoria Regional do Trabalho - 21ª Região
Dominio:  agu.gov.br	Nome: Advocacia-Geral da União
Dominio:  pru-pe.gov.br	Nome: Advocacia Geral da União
Dominio:  pru5.gov.br	Nome: Advocacia Geral da União
Dominio:  purn.gov.br	Nome: Procuradoria da União no RN
Dominio:  creci-es.gov.br	Nome: Conselho Regional de Corretores de Imóveis/13 Reg.
Dominio:  crecies.gov.br	Nome: Conselho Regional de Corretores de Imóveis/13 Reg.
Dominio:  codesa.gov.br	Nome: COMPANHIA DOCAS DO ESPIRITO SANTO
Dominio:  portodevitoria.gov.br	Nome: COMPANHIA DOCAS DO ESPIRITO SANTO
Dominio:  es.gov.br	Nome: Inst. de Tec. da Informação e Comunicação do ES.
Dominio:  rap.gov.br	Nome: MINISTÉRIO PÚBLICO DO ESTADO DO RIO DE JANEIRO
Dominio:  ceturb.gov.br	Nome: Comp de Transp Urb da Grande Vitória
Dominio:  niteroi-artes.gov.br	Nome: Fundação de Arte de Niterói
Dominio:  rio.gov.br	Nome: Empresa Municipal de Informatica s/a
Dominio:  cvm.gov.br	Nome: CVM - COMISSAO DE VALORES MOBILIARIOS
Dominio:  edufinanceiranaescola.gov.br	Nome: CVM - COMISSAO DE VALORES MOBILIARIOS
Dominio:  investidor.gov.br	Nome: CVM - COMISSAO DE VALORES MOBILIARIOS
Dominio:  portaldoinvestidor.gov.br	Nome: CVM - COMISSAO DE VALORES MOBILIARIOS
Dominio:  semanaenef.gov.br	Nome: CVM - COMISSAO DE VALORES MOBILIARIOS
Dominio:  vidaedinheiro.gov.br	Nome: CVM - COMISSAO DE VALORES MOBILIARIOS
Dominio:  crefito2.gov.br	Nome: Conselho Regional de Fisioterapia e Terapia Ocupac
Dominio:  rj.gov.br	Nome: PRODERJ-Centro de Tecnologia da Informação do RJ
Dominio:  cmrj.gov.br	Nome: CAMARA MUNICIPAL DO RIO DE JANEIRO
Dominio:  crm-rj.gov.br	Nome: Conselho Regional de Medicina - CREMERJ
Dominio:  crmrj.gov.br	Nome: Conselho Regional de Medicina - CREMERJ
Dominio:  crtrrj.gov.br	Nome: CONSELHO REGIONAL DE TÉCNICOS EM RADIOLOGIA 4ª R
Dominio:  crefono1.gov.br	Nome: CONSELHO REGIONAL DE FONOAUDIOLOGIA - 1A REGIAO
Dominio:  crfa1.gov.br	Nome: CONSELHO REGIONAL DE FONOAUDIOLOGIA - 1A REGIAO
Dominio:  fonoaudiologia-1.gov.br	Nome: CONSELHO REGIONAL DE FONOAUDIOLOGIA - 1A REGIAO
Dominio:  fonoaudiologia-rj.gov.br	Nome: CONSELHO REGIONAL DE FONOAUDIOLOGIA - 1A REGIAO
Dominio:  trf2.gov.br	Nome: TRIBUNAL REGIONAL FEDERAL DA 2A. REGIAO
Dominio:  eafst.gov.br	Nome: Escola Agrotécnica de Santa Teresa
Dominio:  palmares.gov.br	Nome: Fundação Cultural Palmares / MinC
Dominio:  economizar.gov.br	Nome: PETROLEO BRASILEIRO S.A. - PETROBRAS
Dominio:  conpet.gov.br	Nome: PETROLEO BRASILEIRO S/A - PETROBRAS
Dominio:  petrobras.gov.br	Nome: PETROLEO BRASILEIRO S/A - PETROBRAS
Dominio:  ceplacdf.gov.br	Nome: Comissão Executiva do Plano da Lavoura Cacaueira
Dominio:  ceplac.gov.br	Nome: COMISSAO EXECUTIVA DO PLANO DA LAVOURA CACAUEIRA
Dominio:  cepec.gov.br	Nome: CEPLAC / CEPEC / NUCAD
Dominio:  ceplacpa.gov.br	Nome: COMISSÃO EXECUTIVA DO PLANTIO DA LAVOURA CACAUEIRA
Dominio:  crmvto.gov.br	Nome: Conselho Regional de Medicina Veterinaria TO
Dominio:  creci-rj.gov.br	Nome: Conselho Regional dos Corretores de Imoveis 1 Reg.
Dominio:  brasilre.gov.br	Nome: IRB - BRASIL RESSEGUROS SA
Dominio:  irb-brasilre.gov.br	Nome: IRB - BRASIL RESSEGUROS SA
Dominio:  irb.gov.br	Nome: IRB - BRASIL RESSEGUROS SA
Dominio:  irbbrasilre.gov.br	Nome: IRB - BRASIL RESSEGUROS SA
Dominio:  chesf.gov.br	Nome: COMPANHIA HIDROELETRICA DO SAO FRANCISCO
Dominio:  rffsa.gov.br	Nome: REDE FERROVIARIA FEDERAL S.A.
Dominio:  errec.gov.br	Nome: Rede Ferroviaria federal S/A
Dominio:  dner.gov.br	Nome: Depto Nacional de Estradas de Rodagem - DNER
Dominio:  dner1drf.gov.br	Nome: DNER / 1º Distrito Rodoviário Federal
Dominio:  dner-ce.gov.br	Nome: DNER - 03. DISTRITO RODOVIAVIO FEDERAL
Dominio:  dner-ms.gov.br	Nome: DNER - DEPTº NAC. DE ESTRADAS E RODAGENS
Dominio:  amazonfund-bndes.gov.br	Nome: BANCO NACIONAL DE DESENVOLVIMENTO ECONOMICO E SOCI
Dominio:  amazonfund.gov.br	Nome: BANCO NACIONAL DE DESENVOLVIMENTO ECONOMICO E SOCI
Dominio:  amazoniafund.gov.br	Nome: BANCO NACIONAL DE DESENVOLVIMENTO ECONOMICO E SOCI
Dominio:  amazoniafundo-bndes.gov.br	Nome: BANCO NACIONAL DE DESENVOLVIMENTO ECONOMICO E SOCI
Dominio:  amazoniafundo.gov.br	Nome: BANCO NACIONAL DE DESENVOLVIMENTO ECONOMICO E SOCI
Dominio:  amazonianfund-bndes.gov.br	Nome: BANCO NACIONAL DE DESENVOLVIMENTO ECONOMICO E SOCI
Dominio:  amazonianfund.gov.br	Nome: BANCO NACIONAL DE DESENVOLVIMENTO ECONOMICO E SOCI
Dominio:  bndes.gov.br	Nome: BANCO NACIONAL DE DESENVOLVIMENTO ECONOMICO E SOCI
Dominio:  cartaobndes.gov.br	Nome: BANCO NACIONAL DE DESENVOLVIMENTO ECONOMICO E SOCI
Dominio:  centrodememoriabndes.gov.br	Nome: BANCO NACIONAL DE DESENVOLVIMENTO ECONOMICO E SOCI
Dominio:  ebndes.gov.br	Nome: BANCO NACIONAL DE DESENVOLVIMENTO ECONOMICO E SOCI
Dominio:  fundoamazonia-bndes.gov.br	Nome: BANCO NACIONAL DE DESENVOLVIMENTO ECONOMICO E SOCI
Dominio:  fundoamazonia.gov.br	Nome: BANCO NACIONAL DE DESENVOLVIMENTO ECONOMICO E SOCI
Dominio:  memoriabndes.gov.br	Nome: BANCO NACIONAL DE DESENVOLVIMENTO ECONOMICO E SOCI
Dominio:  finame.gov.br	Nome: Agência Especial de Financiamento Industrial
Dominio:  a2000.gov.br	Nome: SERVICO FEDERAL DE PROCESSAMENTO DE DADOS - SERPRO
Dominio:  bioform.gov.br	Nome: SERVICO FEDERAL DE PROCESSAMENTO DE DADOS - SERPRO
Dominio:  br.gov.br	Nome: SERVICO FEDERAL DE PROCESSAMENTO DE DADOS - SERPRO
Dominio:  brasilsemiseria.gov.br	Nome: SERVICO FEDERAL DE PROCESSAMENTO DE DADOS - SERPRO
Dominio:  brasilsemmiseria.gov.br	Nome: SERVICO FEDERAL DE PROCESSAMENTO DE DADOS - SERPRO
Dominio:  brasiltransparente.gov.br	Nome: SERVICO FEDERAL DE PROCESSAMENTO DE DADOS - SERPRO
Dominio:  cadastrorural.gov.br	Nome: SERVICO FEDERAL DE PROCESSAMENTO DE DADOS - SERPRO
Dominio:  cidadesdigitais.gov.br	Nome: SERVICO FEDERAL DE PROCESSAMENTO DE DADOS - SERPRO
Dominio:  coaf.gov.br	Nome: SERVICO FEDERAL DE PROCESSAMENTO DE DADOS - SERPRO
Dominio:  comprasgovernamentais.gov.br	Nome: SERVICO FEDERAL DE PROCESSAMENTO DE DADOS - SERPRO
Dominio:  comprasnet.gov.br	Nome: SERVICO FEDERAL DE PROCESSAMENTO DE DADOS - SERPRO
Dominio:  computadorparaprofessores.gov.br	Nome: SERVICO FEDERAL DE PROCESSAMENTO DE DADOS - SERPRO
Dominio:  computadorparatodos.gov.br	Nome: SERVICO FEDERAL DE PROCESSAMENTO DE DADOS - SERPRO
Dominio:  consegi.gov.br	Nome: SERVICO FEDERAL DE PROCESSAMENTO DE DADOS - SERPRO
Dominio:  e-car.gov.br	Nome: SERVICO FEDERAL DE PROCESSAMENTO DE DADOS - SERPRO
Dominio:  e.gov.br	Nome: SERVICO FEDERAL DE PROCESSAMENTO DE DADOS - SERPRO
Dominio:  empresa.gov.br	Nome: SERVICO FEDERAL DE PROCESSAMENTO DE DADOS - SERPRO
Dominio:  empresasimples.gov.br	Nome: SERVICO FEDERAL DE PROCESSAMENTO DE DADOS - SERPRO
Dominio:  entespublicos.gov.br	Nome: SERVICO FEDERAL DE PROCESSAMENTO DE DADOS - SERPRO
Dominio:  esocial.gov.br	Nome: SERVICO FEDERAL DE PROCESSAMENTO DE DADOS - SERPRO
Dominio:  expresso.gov.br	Nome: SERVICO FEDERAL DE PROCESSAMENTO DE DADOS - SERPRO
Dominio:  forumsocinfo.gov.br	Nome: SERVICO FEDERAL DE PROCESSAMENTO DE DADOS - SERPRO
Dominio:  frameworkdemoiselle.gov.br	Nome: SERVICO FEDERAL DE PROCESSAMENTO DE DADOS - SERPRO
Dominio:  gespublica.gov.br	Nome: SERVICO FEDERAL DE PROCESSAMENTO DE DADOS - SERPRO
Dominio:  gnre.gov.br	Nome: SERVICO FEDERAL DE PROCESSAMENTO DE DADOS - SERPRO
Dominio:  microepequenaempresa.gov.br	Nome: SERVICO FEDERAL DE PROCESSAMENTO DE DADOS - SERPRO
Dominio:  obrasnet.gov.br	Nome: SERVICO FEDERAL DE PROCESSAMENTO DE DADOS - SERPRO
Dominio:  orcamentofederal.gov.br	Nome: SERVICO FEDERAL DE PROCESSAMENTO DE DADOS - SERPRO
Dominio:  ouvidoriadoservidor.gov.br	Nome: SERVICO FEDERAL DE PROCESSAMENTO DE DADOS - SERPRO
Dominio:  pac.gov.br	Nome: SERVICO FEDERAL DE PROCESSAMENTO DE DADOS - SERPRO
Dominio:  pgfn.gov.br	Nome: SERVICO FEDERAL DE PROCESSAMENTO DE DADOS - SERPRO
Dominio:  portalgoverno.gov.br	Nome: SERVICO FEDERAL DE PROCESSAMENTO DE DADOS - SERPRO
Dominio:  portalsiscomex.gov.br	Nome: SERVICO FEDERAL DE PROCESSAMENTO DE DADOS - SERPRO
Dominio:  quiosque.gov.br	Nome: SERVICO FEDERAL DE PROCESSAMENTO DE DADOS - SERPRO
Dominio:  quiosqueredegoverno.gov.br	Nome: SERVICO FEDERAL DE PROCESSAMENTO DE DADOS - SERPRO
Dominio:  receita.gov.br	Nome: SERVICO FEDERAL DE PROCESSAMENTO DE DADOS - SERPRO
Dominio:  redebrasildigital.gov.br	Nome: SERVICO FEDERAL DE PROCESSAMENTO DE DADOS - SERPRO
Dominio:  redegoverno.gov.br	Nome: SERVICO FEDERAL DE PROCESSAMENTO DE DADOS - SERPRO
Dominio:  redesim.gov.br	Nome: SERVICO FEDERAL DE PROCESSAMENTO DE DADOS - SERPRO
Dominio:  riocmsi.gov.br	Nome: SERVICO FEDERAL DE PROCESSAMENTO DE DADOS - SERPRO
Dominio:  scdp.gov.br	Nome: SERVICO FEDERAL DE PROCESSAMENTO DE DADOS - SERPRO
Dominio:  serpro.gov.br	Nome: SERVICO FEDERAL DE PROCESSAMENTO DE DADOS - SERPRO
Dominio:  siapenet.gov.br	Nome: SERVICO FEDERAL DE PROCESSAMENTO DE DADOS - SERPRO
Dominio:  simples.gov.br	Nome: SERVICO FEDERAL DE PROCESSAMENTO DE DADOS - SERPRO
Dominio:  sintegra.gov.br	Nome: SERVICO FEDERAL DE PROCESSAMENTO DE DADOS - SERPRO
Dominio:  siscomex.gov.br	Nome: SERVICO FEDERAL DE PROCESSAMENTO DE DADOS - SERPRO
Dominio:  smpe.gov.br	Nome: SERVICO FEDERAL DE PROCESSAMENTO DE DADOS - SERPRO
Dominio:  softwarelivre.gov.br	Nome: SERVICO FEDERAL DE PROCESSAMENTO DE DADOS - SERPRO
Dominio:  softwarepublico.gov.br	Nome: SERVICO FEDERAL DE PROCESSAMENTO DE DADOS - SERPRO
Dominio:  solucoestipublica.gov.br	Nome: SERVICO FEDERAL DE PROCESSAMENTO DE DADOS - SERPRO
Dominio:  tesourodireto.gov.br	Nome: SERVICO FEDERAL DE PROCESSAMENTO DE DADOS - SERPRO
Dominio:  uca.gov.br	Nome: SERVICO FEDERAL DE PROCESSAMENTO DE DADOS - SERPRO
Dominio:  xn--oramentofederal-fmb.gov.br	Nome: SERVICO FEDERAL DE PROCESSAMENTO DE DADOS - SERPRO
Dominio:  c-brasil.gov.br	Nome: SERVIÇO FEDERAL DE PROCESSAMENTO DE DADOS - SERPRO
Dominio:  c-brazil.gov.br	Nome: SERVIÇO FEDERAL DE PROCESSAMENTO DE DADOS - SERPRO
Dominio:  gra.gov.br	Nome: SERVIÇO FEDERAL DE PROCESSAMENTO DE DADOS - SERPRO
Dominio:  rais.gov.br	Nome: SERVIÇO FEDERAL DE PROCESSAMENTO DE DADOS - SERPRO
Dominio:  bemrecebercopa.gov.br	Nome: Ministério do Turismo
Dominio:  embratur.gov.br	Nome: Ministério do Turismo
Dominio:  excelenciaemturismo.gov.br	Nome: Ministério do Turismo
Dominio:  mtur.gov.br	Nome: Ministério do Turismo
Dominio:  olaturista.gov.br	Nome: Ministério do Turismo
Dominio:  turismo.gov.br	Nome: Ministério do Turismo
Dominio:  turismobrasil.gov.br	Nome: Ministério do Turismo
Dominio:  capitalderisco.gov.br	Nome: FINANCIADORA DE ESTUDOS E PROJETOS - FINEP
Dominio:  finep.gov.br	Nome: FINANCIADORA DE ESTUDOS E PROJETOS - FINEP
Dominio:  venturecapital.gov.br	Nome: FINANCIADORA DE ESTUDOS E PROJETOS - FINEP
Dominio:  unasus.gov.br	Nome: FUNDACAO OSWALDO CRUZ
Dominio:  censo.gov.br	Nome: FUNDACAO INST BRAS DE GEOGRAFIA E ESTATISTICA IBGE
Dominio:  censo2000.gov.br	Nome: FUNDACAO INST BRAS DE GEOGRAFIA E ESTATISTICA IBGE
Dominio:  concar.gov.br	Nome: FUNDACAO INST BRAS DE GEOGRAFIA E ESTATISTICA IBGE
Dominio:  fibge.gov.br	Nome: FUNDACAO INST BRAS DE GEOGRAFIA E ESTATISTICA IBGE
Dominio:  ibge.gov.br	Nome: FUNDACAO INST BRAS DE GEOGRAFIA E ESTATISTICA IBGE
Dominio:  inde.gov.br	Nome: FUNDACAO INST BRAS DE GEOGRAFIA E ESTATISTICA IBGE
Dominio:  ibge2.gov.br	Nome: IBGE - Instituto Brasileiro de Geografia
Dominio:  frp.gov.br	Nome: FUNDACAO ROQUETTE PINTO
Dominio:  cnpd.gov.br	Nome: IPEA -INSTITUTO DE PESQUISA ECONOMICA APLICADA
Dominio:  federativo.gov.br	Nome: IPEA -INSTITUTO DE PESQUISA ECONOMICA APLICADA
Dominio:  ipea.gov.br	Nome: IPEA -INSTITUTO DE PESQUISA ECONOMICA APLICADA
Dominio:  ipeadata.gov.br	Nome: IPEA -INSTITUTO DE PESQUISA ECONOMICA APLICADA
Dominio:  mestradoprofissional.gov.br	Nome: IPEA -INSTITUTO DE PESQUISA ECONOMICA APLICADA
Dominio:  portalfederativo.gov.br	Nome: IPEA -INSTITUTO DE PESQUISA ECONOMICA APLICADA
Dominio:  anapost.gov.br	Nome: Empresa Brasileira de Correios e Telégrafos
Dominio:  correio.gov.br	Nome: Empresa Brasileira de Correios e Telégrafos
Dominio:  correios.gov.br	Nome: Empresa Brasileira de Correios e Telégrafos
Dominio:  e-post.gov.br	Nome: Empresa Brasileira de Correios e Telégrafos
Dominio:  ect.gov.br	Nome: Empresa Brasileira de Correios e Telégrafos
Dominio:  epost.gov.br	Nome: Empresa Brasileira de Correios e Telégrafos
Dominio:  reformapostal.gov.br	Nome: Empresa Brasileira de Correios e Telégrafos
Dominio:  correios-ce.gov.br	Nome: EMPRESA BRASILEIRA DE CORREIOS E TELEGRAFOS
Dominio:  codern.gov.br	Nome: COMPANHIA DAS DOCAS DO RIO GRANDE DO NORTE
Dominio:  cfa.gov.br	Nome: CFA - CONSELHO FEDERAL DE ADMINISTRACAO
Dominio:  casadamoeda.gov.br	Nome: CASA DA MOEDA DO BRASIL CMB
Dominio:  cmb.gov.br	Nome: CASA DA MOEDA DO BRASIL CMB
Dominio:  eafc-pa.gov.br	Nome: Escola Agrotécnica Federal de Castanhal
Dominio:  tjap.gov.br	Nome: TRIBUNAL DE JUSTICA DO ESTADO DO AMAPA
Dominio:  tre-ap.gov.br	Nome: Tribunal Regional Eleitoral do Amapá
Dominio:  al.gov.br	Nome: FUNDACAO DE AMPARO A PESQUISA DO ESTADO DE ALAGOAS
Dominio:  agronet-pe.gov.br	Nome: ESCOLA AGROTECNICA FEDERAL DE BELO JARDIM
Dominio:  trt19.gov.br	Nome: TRT da 19a Regiao
Dominio:  eafcol.gov.br	Nome: Escola Agrotécnica Federal de Colatina
Dominio:  transportes.gov.br	Nome: MINISTERIO DOS TRANSPORTES
Dominio:  trensurb.gov.br	Nome: MINISTERIO DOS TRANSPORTES
Dominio:  caged.gov.br	Nome: MINISTERIO DO TRABALHO E EMPREGO
Dominio:  fat.gov.br	Nome: MINISTERIO DO TRABALHO E EMPREGO
Dominio:  mtb.gov.br	Nome: MINISTERIO DO TRABALHO E EMPREGO
Dominio:  mte.gov.br	Nome: MINISTERIO DO TRABALHO E EMPREGO
Dominio:  mtecbo.gov.br	Nome: MINISTERIO DO TRABALHO E EMPREGO
Dominio:  mtecbo2000.gov.br	Nome: MINISTERIO DO TRABALHO E EMPREGO
Dominio:  trabalho.gov.br	Nome: MINISTERIO DO TRABALHO E EMPREGO
Dominio:  mtbauru.gov.br	Nome: Ministério do Trabalho e Emprego - MTE
Dominio:  ambiente.gov.br	Nome: MINISTERIO DO MEIO AMBIENTE
Dominio:  brazilenvironment-mobile.gov.br	Nome: MINISTERIO DO MEIO AMBIENTE
Dominio:  brazilsenvironment.gov.br	Nome: MINISTERIO DO MEIO AMBIENTE
Dominio:  conferenciameioambiente.gov.br	Nome: MINISTERIO DO MEIO AMBIENTE
Dominio:  consumosustentavel.gov.br	Nome: MINISTERIO DO MEIO AMBIENTE
Dominio:  environment.gov.br	Nome: MINISTERIO DO MEIO AMBIENTE
Dominio:  florestal.gov.br	Nome: MINISTERIO DO MEIO AMBIENTE
Dominio:  iufro2019.gov.br	Nome: MINISTERIO DO MEIO AMBIENTE
Dominio:  meioambiente.gov.br	Nome: MINISTERIO DO MEIO AMBIENTE
Dominio:  meioambientedobrasil.gov.br	Nome: MINISTERIO DO MEIO AMBIENTE
Dominio:  ministeriodomeioambiente.gov.br	Nome: MINISTERIO DO MEIO AMBIENTE
Dominio:  mma.gov.br	Nome: MINISTERIO DO MEIO AMBIENTE
Dominio:  nossoambiente.gov.br	Nome: MINISTERIO DO MEIO AMBIENTE
Dominio:  p2r2.gov.br	Nome: MINISTERIO DO MEIO AMBIENTE
Dominio:  passaporteverde.gov.br	Nome: MINISTERIO DO MEIO AMBIENTE
Dominio:  portalambiental.gov.br	Nome: MINISTERIO DO MEIO AMBIENTE
Dominio:  programaarpa.gov.br	Nome: MINISTERIO DO MEIO AMBIENTE
Dominio:  redemulheres.gov.br	Nome: MINISTERIO DO MEIO AMBIENTE
Dominio:  redepcs.gov.br	Nome: MINISTERIO DO MEIO AMBIENTE
Dominio:  retp.gov.br	Nome: MINISTERIO DO MEIO AMBIENTE
Dominio:  sacoeumsaco.gov.br	Nome: MINISTERIO DO MEIO AMBIENTE
Dominio:  segurancaquimica.gov.br	Nome: MINISTERIO DO MEIO AMBIENTE
Dominio:  separeolixo.gov.br	Nome: MINISTERIO DO MEIO AMBIENTE
Dominio:  servicoflorestal.gov.br	Nome: MINISTERIO DO MEIO AMBIENTE
Dominio:  sinir.gov.br	Nome: MINISTERIO DO MEIO AMBIENTE
Dominio:  sisgen.gov.br	Nome: MINISTERIO DO MEIO AMBIENTE
Dominio:  cnrh.gov.br	Nome: SECRETARIA DE RECURSOS HIDRICOS E AMBIENTE URBANO
Dominio:  proagua.gov.br	Nome: SECRETARIA DE RECURSOS HIDRICOS E AMBIENTE URBANO
Dominio:  jbrj.gov.br	Nome: INSTITUTO DE PESQUISAS JARDIM BOTANICO DO RIO =
Dominio:  ccpe.gov.br	Nome: MINISTERIO DE MINAS E ENERGIA
Dominio:  energiabrasil.gov.br	Nome: MINISTERIO DE MINAS E ENERGIA
Dominio:  mme.gov.br	Nome: MINISTERIO DE MINAS E ENERGIA
Dominio:  poupeenergia.gov.br	Nome: MINISTERIO DE MINAS E ENERGIA
Dominio:  dnc.gov.br	Nome: Agência Nacional do Petróleo - DNC
Dominio:  trt24.gov.br	Nome: TRIBUNAL REGIONAL DO TRABALHO DA 24A REGIAO
Dominio:  trtms.gov.br	Nome: TRIBUNAL REGIONAL DO TRABALHO DA 24A REGIAO
Dominio:  trt23.gov.br	Nome: TRIBUNAL REGIONAL DO TRABALHO - 23 REGIAO
Dominio:  crecito.gov.br	Nome: CONSELHO REGIONAL DE CORRETORES DE IMOVEIS 25 REG
Dominio:  esamur.gov.br	Nome: Agência. San. Básico do Mun. Resende SANEAR
Dominio:  bn.gov.br	Nome: FUNDACAO BIBLIOTECA NACIONAL
Dominio:  documenta.gov.br	Nome: FUNDACAO BIBLIOTECA NACIONAL
Dominio:  fbn.gov.br	Nome: FUNDACAO BIBLIOTECA NACIONAL
Dominio:  eafvsa.gov.br	Nome: Instituto Federal de Pernambuco Campus Vitória
Dominio:  eafcrato.gov.br	Nome: Escola Agrotécnica Federal de Crato
Dominio:  eafigt.gov.br	Nome: ESCOLA AGROTECNICA FEDERAL DE IGUATU-C
Dominio:  valec.gov.br	Nome: VALEC - ENGENHARIA, CONSTRUÇÕES E FERROVIAS S.A.
Dominio:  portosrio.gov.br	Nome: Companhia Docas do Rio de Janeiro
Dominio:  susep.gov.br	Nome: Superintendência de Seguros Privados
Dominio:  cbtu.gov.br	Nome: Companhia Brasileira de Trens Urbanos
Dominio:  metrobh.gov.br	Nome: Companhia Brasileira de Trens Urbanos
Dominio:  cbtu-sturec.gov.br	Nome: COMPANHIA BRASILEIRA DE TRENS URBANOS
Dominio:  cbtumetrorec.gov.br	Nome: COMPANHIA BRASILEIRA DE TRENS URBANOS
Dominio:  cbtu-natal.gov.br	Nome: Companhia Brasileira de Trens Urbanos-Gerencia Nat
Dominio:  cbtujp.gov.br	Nome: Companhia Brasileira de Trens Urbanos
Dominio:  cp2.gov.br	Nome: Colégio Pedro II
Dominio:  dtpdf.gov.br	Nome: DATAPREV DF
Dominio:  inss.gov.br	Nome: DATAPREV DF
Dominio:  previdenciasocial.gov.br	Nome: DATAPREV DF
Dominio:  xn--assistnciasocial-xqb.gov.br	Nome: DATAPREV DF
Dominio:  xn--previdnciasocial-xqb.gov.br	Nome: DATAPREV DF
Dominio:  cnis.gov.br	Nome: EMP. DE TEC. E INFORMACOES DA PREVIDENCIA SOCIAL
Dominio:  dataprev.gov.br	Nome: EMP. DE TEC. E INFORMACOES DA PREVIDENCIA SOCIAL
Dominio:  previdencia.gov.br	Nome: EMP. DE TEC. E INFORMACOES DA PREVIDENCIA SOCIAL
Dominio:  sirc.gov.br	Nome: EMP. DE TEC. E INFORMACOES DA PREVIDENCIA SOCIAL
Dominio:  xn--previdncia-r7a.gov.br	Nome: EMP. DE TEC. E INFORMACOES DA PREVIDENCIA SOCIAL
Dominio:  nuclebras.gov.br	Nome: Nuclebras Equipamentos Pesados S.A.
Dominio:  nuclep.gov.br	Nome: NUCLEBRÁS EQUIPAMENTOS PESADOS S.A.
Dominio:  casaruibarbosa.gov.br	Nome: Fundacao Casa de Rui Barbosa
Dominio:  rb.gov.br	Nome: Fundacao Casa de Rui Barbosa
Dominio:  inpi.gov.br	Nome: INPI - INSTITUTO NAC. DA PROPRIEDADE INDUSTRIAL
Dominio:  eletronuclear.gov.br	Nome: Eletrobrás Termonuclear SA
Dominio:  eafajt.gov.br	Nome: Escola Agrotécnica Federal Antônio José Teixeira
Dominio:  eafguanambi.gov.br	Nome: Escola Agrotécnica Federal Antônio José Teixeira
Dominio:  crasp.gov.br	Nome: Conselho Regional de Administração de São Paulo
Dominio:  coren-sp.gov.br	Nome: Conselho Regional de Enfermagem de SP
Dominio:  corensp.gov.br	Nome: Conselho Regional de Enfermagem de SP
Dominio:  codesp.gov.br	Nome: COMPANHIA DOCAS DO EST DE SAO PAULO - CODESP
Dominio:  portodesantos.gov.br	Nome: COMPANHIA DOCAS DO EST DE SAO PAULO - CODESP
Dominio:  ahrana.gov.br	Nome: ADIMINISTRAÇÃO DA HIDROVIA DO PARANÁ-AHRANA
Dominio:  ahipar.gov.br	Nome: AHIPAR ADMINISTRAÇÃO DA HIDROVIA DO PARAGUAI
Dominio:  comunidadenegra.gov.br	Nome: Casa Civil
Dominio:  cofen.gov.br	Nome: CONSELHO FEDERAL DE ENFERMAGEM
Dominio:  portalcofen.gov.br	Nome: CONSELHO FEDERAL DE ENFERMAGEM
Dominio:  crefito-sp.gov.br	Nome: CONS REG DE FISIOTERAPIA E TERAP OCUP TRES REG
Dominio:  crefitosp.gov.br	Nome: CONS REG DE FISIOTERAPIA E TERAP OCUP TRES REG
Dominio:  crmvsp.gov.br	Nome: Conselho Regional de Med.Veterinária de SP
Dominio:  seade.gov.br	Nome: FUNDACAO SEADE SISTEMA ESTADUAL DE ANALISE DE DADO
Dominio:  cfbm.gov.br	Nome: CONSELHO FEDERAL DE BIOMEDICINA
Dominio:  trf3.gov.br	Nome: Tribunal Regional Federal da Terceira Regiao
Dominio:  butantan.gov.br	Nome: Instituto Butantan
Dominio:  crbm1.gov.br	Nome: Conselho Regional de Biomedicina 1º Regiao
Dominio:  fundacentro.gov.br	Nome: FUNDACENTRO - FUND.JORGE D.F. SEG. E MED. DO TRAB.
Dominio:  fundacentrorj.gov.br	Nome: Fundacao J. D. F. de Seg. e Medicina do Trabalho
Dominio:  fundacentro-pe.gov.br	Nome: FUNDACENTRO - FUNDACAO JORGE DUPRAT FIGUEIREDO DE
Dominio:  fundacentro-es.gov.br	Nome: Fund. Jorge Duprat Figueiredo de Seg. Med Trabalho
Dominio:  fundacentro-ba.gov.br	Nome: FUNDACAO JORGE DUPRAT FIGUEIREDO DE SEG.E MED.TRAB
Dominio:  fundacentroms.gov.br	Nome: FUNDAÇÃO JORGE DUPRAT FIGUEIREDO DE SEG
Dominio:  ceagesp.gov.br	Nome: Companhia de Entrepostos e Armazéns Gerais de SP
Dominio:  sp.gov.br	Nome: Cia Proc. de Dados do Estado de S Paulo - Prodesp
Dominio:  creci-sp.gov.br	Nome: CONSELHO REGIONAL DE CORRETORES DE IMOVEIS SP
Dominio:  crecisp.gov.br	Nome: CONSELHO REGIONAL DE CORRETORES DE IMOVEIS SP
Dominio:  cofeci.gov.br	Nome: CONSELHO FEDERAL DE CORRETORES DE IMÓVEIS
Dominio:  convensi.gov.br	Nome: CONSELHO FEDERAL DE CORRETORES DE IMÓVEIS
Dominio:  cremesp.gov.br	Nome: CONSELHO REGIONAL DE MEDICINA - SP
Dominio:  ma.gov.br	Nome: SEPLAN - Governo do Estado do Maranhão
Dominio:  maranhao.gov.br	Nome: SEPLAN - Governo do Estado do Maranhão
Dominio:  eafs.gov.br	Nome: ESCOLA AGROTECNICA FEDERAL DE SATUBA - AL
Dominio:  eafbambui.gov.br	Nome: CENTRO FEDERAL DE EDUCAÇÃO TECNOLÓGICA DE BAMBUÍ
Dominio:  eafudi.gov.br	Nome: Escola Agrotécnica Federal de Uberlândia
Dominio:  eafsertao.gov.br	Nome: Escola Agrotécnica Federal de Sertão
Dominio:  eafsc.gov.br	Nome: Escola Agrotécnica Federal de São Cristóvão - SE
Dominio:  eafc.gov.br	Nome: Instituto Federal de Mato Grosso - Cáceres
Dominio:  agronet.gov.br	Nome: Escola Agrotécnica Federal de São João Evangelista
Dominio:  eafi.gov.br	Nome: ESCOLA AGROTECNICA FEDERAL DE INCONFIDENTES
Dominio:  eafuberaba.gov.br	Nome: CEFET CENTRO FED EDUCAÇÃO TECNOLOGICA DE UBERABA
Dominio:  eafmachado.gov.br	Nome: Escola Agrotécnica Federal de Machado
Dominio:  eafmuz.gov.br	Nome: Instituto Federal Sul de Minas Gerais
Dominio:  eafb.gov.br	Nome: ESCOLA AGROTECNICA FEDERAL DE BARREIROS-PE
Dominio:  eafsombrio.gov.br	Nome: Instituto Federal Catarinense Campus Santa Rosa
Dominio:  eafsl.gov.br	Nome: Escola Agrotécnica Federal de São Luiz
Dominio:  eafce.gov.br	Nome: Escola Agrotécnica Federal de Ceres
Dominio:  corenpr.gov.br	Nome: Conselho Regional de Enfermagem do Paraná
Dominio:  corensc.gov.br	Nome: Conselho Regional de Enfermagem de Santa Catarina
Dominio:  ipardes.gov.br	Nome: INSTITUTO PARANAENSE DE DESENVOLVIMENTO ECONOMICO
Dominio:  crq-9.gov.br	Nome: CONSELHO REGIONAL DE QUÍMICA DA 9A REGIÃO
Dominio:  crq-pr.gov.br	Nome: CONSELHO REGIONAL DE QUÍMICA DA 9A REGIÃO
Dominio:  crq9.gov.br	Nome: CONSELHO REGIONAL DE QUÍMICA DA 9A REGIÃO
Dominio:  crqpr.gov.br	Nome: CONSELHO REGIONAL DE QUÍMICA DA 9A REGIÃO
Dominio:  telepar.gov.br	Nome: Oi S.A.
Dominio:  telesc.gov.br	Nome: Oi S.A.
Dominio:  celepar.gov.br	Nome: CIA. DE TECNOL. DA INFOR. E COMUNICAÇÃO DO PARANÁ
Dominio:  e-parana.gov.br	Nome: CIA. DE TECNOL. DA INFOR. E COMUNICAÇÃO DO PARANÁ
Dominio:  netgoverno.gov.br	Nome: CIA. DE TECNOL. DA INFOR. E COMUNICAÇÃO DO PARANÁ
Dominio:  parana.gov.br	Nome: CIA. DE TECNOL. DA INFOR. E COMUNICAÇÃO DO PARANÁ
Dominio:  pr.gov.br	Nome: CIA. DE TECNOL. DA INFOR. E COMUNICAÇÃO DO PARANÁ
Dominio:  redecidadao.gov.br	Nome: CIA. DE TECNOL. DA INFOR. E COMUNICAÇÃO DO PARANÁ
Dominio:  creci-pr.gov.br	Nome: CRECI-PR ORGANIZACAO DE CORRETORES DE IMOV=
Dominio:  crecipr.gov.br	Nome: CRECI-PR ORGANIZACAO DE CORRETORES DE IMOV=
Dominio:  seti.gov.br	Nome: SECRETARIA DE ESTADO DA CIENCIA, TECNOLOGIA
Dominio:  cra-pr.gov.br	Nome: Conselho Regional de Administração do Paraná
Dominio:  crq13.gov.br	Nome: CONSELHO REGIONAL DE QUIMICA DA 13A REGIAO.
Dominio:  crqsc.gov.br	Nome: CONSELHO REGIONAL DE QUIMICA DA 13A REGIAO.
Dominio:  creci-sc.gov.br	Nome: CONSELHO REGIONAL DE CORRETORES DE IMOVEIS -=
Dominio:  badesc.gov.br	Nome: AGENCIA DE FOMENTO DO ESTADO DE SANTA CATARINA S.A
Dominio:  ciasc.gov.br	Nome: Centro de Informatica e Automacao do Estado de SC
Dominio:  sc.gov.br	Nome: Centro de Informatica e Automacao do Estado de SC
Dominio:  scnet.gov.br	Nome: Centro de Informatica e Automacao do Estado de SC
Dominio:  crfsc.gov.br	Nome: Conselho Regional de Farmácia do Estado de SC
Dominio:  rr.gov.br	Nome: Governo do Estado de Roraima
Dominio:  eafsgc.gov.br	Nome: ESCOLA AGROTEC FED DE SAO GABRIEL DA CACHOEIRA
Dominio:  eafmanaus.gov.br	Nome: ESCOLA AGROTECNICA FEDERAL DE MANAUS
Dominio:  eafco.gov.br	Nome: Escola Agrotécnica Federal de Colorado do Oeste
Dominio:  aeb.gov.br	Nome: Agência Espacial Brasileira
Dominio:  agespacial.gov.br	Nome: Agência Espacial Brasileira
Dominio:  vls.gov.br	Nome: Agência Espacial Brasileira
Dominio:  portalcoren-rs.gov.br	Nome: Conselho Regional de Enfermagem - RS
Dominio:  rs.gov.br	Nome: PROCERGS - Cia de Processamento de Dados do RGS
Dominio:  eafars.gov.br	Nome: Escola Agrotécnica Federal de Alegrete
Dominio:  trf4.gov.br	Nome: Tribunal Regional Federal da 4ª Região
Dominio:  crm.gov.br	Nome: Companhia Riograndense de Mineração
Dominio:  crt.gov.br	Nome: COMPANHIA RIOGRANDENSE DE TELECOMUNICACOES
Dominio:  creci-rs.gov.br	Nome: CONSELHO REGIONAL DE CORRETORES DE IMOVEIS 3A. REG
Dominio:  crmvrs.gov.br	Nome: onselho Reg.de Medicina Veterinaria do RS-CRMV
Dominio:  cefetsvs.gov.br	Nome: INSTITUTO FEDERAL FARROUPILHA
Dominio:  cefetbg.gov.br	Nome: Centro Federal de Educação Tecno Bento G
Dominio:  prr4.gov.br	Nome: PROCURADORIA REGIONAL DA REPUBLICA DA 4ª REGIÃO
Dominio:  veracruz-rs.gov.br	Nome: Vera Cruz Prefeitura Municipal
Dominio:  telebrasilia.gov.br	Nome: TELEBRASILIA S.A.
